AAAAAACTAAC -> AAAAACTAACG
AAAAACTAACG -> AAAACTAACGG
AAAAAGAAAAC -> AAAAGAAAACG
AAAACCCCTTT -> AAACCCCTTTG
AAAACGTCATT -> AAACGTCATTC
AAAACTAACGG -> AAACTAACGGA
AAAAGAAAACG -> AAAGAAAACGT
AAAAGCGTGTC -> AAAGCGTGTCT
AAAAGTCAGGA -> AAAGTCAGGAA
AAAATTGGCAA -> AAATTGGCAAC
AAACATACGGA -> AACATACGGAC
AAACATGTTGG -> AACATGTTGGA
AAACCCCTTTG -> AACCCCTTTGC
AAACCTTTCGC -> AACCTTTCGCC
AAACGTCATTC -> AACGTCATTCA
AAACTAACGGA -> AACTAACGGAG
AAACTACAGTA -> AACTACAGTAA
AAACTATGCTA -> AACTATGCTAC
AAAGAAAACGT -> AAGAAAACGTC
AAAGCGTGTCT -> AAGCGTGTCTG
AAAGCTTGTGA -> AAGCTTGTGAA
AAAGGCAGGGA -> AAGGCAGGGAT
AAAGGTTTCAT -> AAGGTTTCATT
AAAGTCAGGAA -> AAGTCAGGAAA
AAAGTCGTCTC -> AAGTCGTCTCA
AAAGTGAATTC -> AAGTGAATTCT
AAATAGGCAAA -> AATAGGCAAAC
AAATCTATCCC -> AATCTATCCCT
AAATCTCGCCA -> AATCTCGCCAT
AAATTGGCAAC -> AATTGGCAACC
AACAACAGTAT -> ACAACAGTATT
AACAAGAATTT -> ACAAGAATTTT
AACAAGCCACG -> ACAAGCCACGC
AACAAGCGGCT -> ACAAGCGGCTT
AACACCGAATC -> ACACCGAATCG
AACAGTATTGC -> ACAGTATTGCC
AACATACGGAC -> ACATACGGACG
AACATGTTGGA -> ACATGTTGGAC
AACCAACCTCC -> ACCAACCTCCT
AACCATTACCC -> ACCATTACCCG
AACCCCTTTGC -> ACCCCTTTGCG
AACCGGGGCCA -> ACCGGGGCCAT
AACCTCCTAGG -> ACCTCCTAGGC
AACCTTACTAC -> ACCTTACTACT
AACCTTTCGCC -> ACCTTTCGCCT
AACGCTGATTC -> ACGCTGATTCC
AACGGACTGAT -> ACGGACTGATC
AACGGAGCCTC -> ACGGAGCCTCA
AACGGCTACTA -> ACGGCTACTAG
AACGTCATTCA -> ACGTCATTCAG
AACGTGGGCGA -> ACGTGGGCGAC
AACTAACGGAG -> ACTAACGGAGC
AACTACAGTAA -> ACTACAGTAAA
AACTACTTACG -> ACTACTTACGC
AACTATGCTAC -> ACTATGCTACT
AACTCGAATTC -> ACTCGAATTCC
AACTCGACATA -> ACTCGACATAT
AACTGCAGTCT -> ACTGCAGTCTT
AACTGGTACTC -> ACTGGTACTCC
AACTGTCTGTT -> ACTGTCTGTTC
AACTTAATAAG -> ACTTAATAAGT
AAGAAAACGTC -> AGAAAACGTCA
AAGAAGTGCGC -> AGAAGTGCGCG
AAGAATCGTCG -> AGAATCGTCGA
AAGAATTTTGG -> AGAATTTTGGT
AAGCATTTTCG -> AGCATTTTCGT
AAGCCACGCAT -> AGCCACGCATC
AAGCCCCTTCA -> AGCCCCTTCAG
AAGCGGCTTAG -> AGCGGCTTAGC
AAGCGTGTCTG -> AGCGTGTCTGG
AAGCTCTGCCA -> AGCTCTGCCAG
AAGCTGAGCTG -> AGCTGAGCTGA
AAGCTTGTGAA -> AGCTTGTGAAC
AAGCTTTGGAG -> AGCTTTGGAGG
AAGGAATTCGG -> AGGAATTCGGA
AAGGCAGGGAT -> AGGCAGGGATA
AAGGGAGGGGC -> AGGGAGGGGCG
AAGGTCAATCC -> AGGTCAATCCC
AAGGTTTCATT -> AGGTTTCATTG
AAGTACGCATG -> AGTACGCATGG
AAGTCAGGAAA -> AGTCAGGAAAA
AAGTCGTCTCA -> AGTCGTCTCAA
AAGTGAATTCT -> AGTGAATTCTT
AAGTGCGCGTC -> AGTGCGCGTCG
AAGTGCGTTAC -> AGTGCGTTACA
AAGTTCCCTAA -> AGTTCCCTAAG
AAGTTGACTGA -> AGTTGACTGAG
AAGTTGATTTT -> AGTTGATTTTC
AATAAATAGGC -> ATAAATAGGCA
AATAACTGTCT -> ATAACTGTCTG
AATAAGTGCGT -> ATAAGTGCGTT
AATACTACATT -> ATACTACATTC
AATACTCCCGT -> ATACTCCCGTC
AATAGGCAAAC -> ATAGGCAAACT
AATAGTCACGT -> ATAGTCACGTT
AATATTTAGAT -> ATATTTAGATT
AATATTTTCAC -> ATATTTTCACT
AATCAAATCTC -> ATCAAATCTCG
AATCCCATGAG -> ATCCCATGAGA
AATCCCGCTTC -> ATCCCGCTTCA
AATCGCGCGAA -> ATCGCGCGAAG
AATCGCTATTA -> ATCGCTATTAG
AATCGGATTCC -> ATCGGATTCCA
AATCGTCGAGG -> ATCGTCGAGGC
AATCTATCCCT -> ATCTATCCCTA
AATCTCGCCAT -> ATCTCGCCATT
AATCTTTGGAA -> ATCTTTGGAAG
AATGACATACT -> ATGACATACTT
AATGATACAGA -> ATGATACAGAT
AATGCGCTAGT -> ATGCGCTAGTT
AATGGAATAGT -> ATGGAATAGTC
AATGTTATGCT -> ATGTTATGCTG
AATTACTAGTG -> ATTACTAGTGC
AATTCCGCATC -> ATTCCGCATCG
AATTCGACCTC -> ATTCGACCTCA
AATTCGAGTAG -> ATTCGAGTAGA
AATTCGGATGT -> ATTCGGATGTT
AATTCTTTCCA -> ATTCTTTCCAC
AATTGGAAAAG -> ATTGGAAAAGT
AATTGGCAACC -> ATTGGCAACCG
AATTTGTGTGA -> ATTTGTGTGAT
AATTTTGGTAT -> ATTTTGGTATA
ACAACAAGAAT -> CAACAAGAATT
ACAACAGTATT -> CAACAGTATTG
ACAACGGCTAC -> CAACGGCTACT
ACAAGAATTTT -> CAAGAATTTTG
ACAAGCCACGC -> CAAGCCACGCA
ACAAGCCCCTT -> CAAGCCCCTTC
ACAAGCGGCTT -> CAAGCGGCTTA
ACAATACTCCC -> CAATACTCCCG
ACAATCGGATT -> CAATCGGATTC
ACAATGACATA -> CAATGACATAC
ACACCGAATCG -> CACCGAATCGC
ACACGGGTGTT -> CACGGGTGTTA
ACACGTTGTGG -> CACGTTGTGGG
ACACTCTCCTT -> CACTCTCCTTT
ACACTGCAAGG -> CACTGCAAGGA
ACACTGGGACC -> CACTGGGACCC
ACAGATCAGCC -> CAGATCAGCCA
ACAGCGAACTA -> CAGCGAACTAC
ACAGTAAAACC -> CAGTAAAACCC
ACAGTACGATT -> CAGTACGATTA
ACAGTATTGCC -> CAGTATTGCCC
ACAGTCATGTG -> CAGTCATGTGG
ACAGTCTTGTC -> CAGTCTTGTCT
ACATACACTCT -> CATACACTCTC
ACATACGGACG -> CATACGGACGA
ACATACTATCT -> CATACTATCTC
ACATACTTGAC -> CATACTTGACA
ACATATTTCCT -> CATATTTCCTG
ACATGTCGACA -> CATGTCGACAT
ACATGTTGGAC -> CATGTTGGACG
ACATTATAACT -> CATTATAACTG
ACATTCATGTC -> CATTCATGTCC
ACATTGAGAAG -> CATTGAGAAGT
ACATTGCGCCC -> CATTGCGCCCT
ACCAACCTCCT -> CCAACCTCCTA
ACCATGGCCCA -> CCATGGCCCAT
ACCATGTTCAT -> CCATGTTCATA
ACCATTACCCG -> CCATTACCCGT
ACCCCTTTGCG -> CCCCTTTGCGC
ACCCGTTGCCC -> CCCGTTGCCCA
ACCCTCTACAT -> CCCTCTACATA
ACCCTGCTAAC -> CCCTGCTAACG
ACCGAATCGCT -> CCGAATCGCTA
ACCGAGGCGAT -> CCGAGGCGATG
ACCGAGTTATT -> CCGAGTTATTG
ACCGATGCTGC -> CCGATGCTGCT
ACCGGGGCCAT -> CCGGGGCCATG
ACCGTCTAGTT -> CCGTCTAGTTA
ACCGTTAATTG -> CCGTTAATTGG
ACCTATCGGAC -> CCTATCGGACG
ACCTCAATACT -> CCTCAATACTA
ACCTCCGTCAT -> CCTCCGTCATG
ACCTCCTAGGC -> CCTCCTAGGCA
ACCTCGGCTCC -> CCTCGGCTCCT
ACCTTACTACT -> CCTTACTACTA
ACCTTCCTTGC -> CCTTCCTTGCG
ACCTTTCGCCT -> CCTTTCGCCTA
ACGAGAATGCG -> CGAGAATGCGC
ACGAGCCATTC -> CGAGCCATTCA
ACGATCCCAAC -> CGATCCCAACT
ACGATTAACTC -> CGATTAACTCG
ACGATTGGTAT -> CGATTGGTATG
ACGCAAAAAAC -> CGCAAAAAACT
ACGCAGCGCTT -> CGCAGCGCTTC
ACGCATCAGGA -> CGCATCAGGAG
ACGCATGGACT -> CGCATGGACTA
ACGCCTACAGT -> CGCCTACAGTA
ACGCCTGGAAA -> CGCCTGGAAAC
ACGCTGATTCC -> CGCTGATTCCC
ACGGACGATTG -> CGGACGATTGG
ACGGACTGATC -> CGGACTGATCG
ACGGAGCCTCA -> CGGAGCCTCAG
ACGGCTACTAG -> CGGCTACTAGC
ACGGGACAAGC -> CGGGACAAGCC
ACGGGTGTTAG -> CGGGTGTTAGG
ACGTAGGATGG -> CGTAGGATGGC
ACGTCATTCAG -> CGTCATTCAGA
ACGTCCTGTGT -> CGTCCTGTGTG
ACGTCTGTTCC -> CGTCTGTTCCA
ACGTGACAACG -> CGTGACAACGG
ACGTGCAACAC -> CGTGCAACACC
ACGTGGGCGAC -> CGTGGGCGACG
ACGTTCGGACA -> CGTTCGGACAG
ACGTTGTGGGC -> CGTTGTGGGCT
ACTAACGGAGC -> CTAACGGAGCC
ACTAACTGGTA -> CTAACTGGTAC
ACTAAGCTCTG -> CTAAGCTCTGC
ACTACAGTAAA -> CTACAGTAAAA
ACTACATTCAT -> CTACATTCATG
ACTACTAAGCT -> CTACTAAGCTC
ACTACTTACGC -> CTACTTACGCC
ACTAGCGACTG -> CTAGCGACTGC
ACTAGTGCTTG -> CTAGTGCTTGG
ACTATCGGGCC -> CTATCGGGCCG
ACTATCTCTCC -> CTATCTCTCCT
ACTATGCTACT -> CTATGCTACTT
ACTCCCGTCCG -> CTCCCGTCCGT
ACTCCTGCAAG -> CTCCTGCAAGA
ACTCGAATTCC -> CTCGAATTCCG
ACTCGACATAT -> CTCGACATATT
ACTCGATGTAG -> CTCGATGTAGG
ACTCTCCTTTA -> CTCTCCTTTAT
ACTGACGTGCA -> CTGACGTGCAA
ACTGAGAACGC -> CTGAGAACGCT
ACTGATCGGAA -> CTGATCGGAAC
ACTGCAAGGAA -> CTGCAAGGAAT
ACTGCAGTCTT -> CTGCAGTCTTC
ACTGCAGTGGA -> CTGCAGTGGAC
ACTGGGACCCT -> CTGGGACCCTG
ACTGGTACTCC -> CTGGTACTCCT
ACTGTAATTTG -> CTGTAATTTGT
ACTGTCTGTTC -> CTGTCTGTTCC
ACTGTGCTGCG -> CTGTGCTGCGT
ACTTAATAAGT -> CTTAATAAGTG
ACTTACGCCTA -> CTTACGCCTAC
ACTTCAAAGTC -> CTTCAAAGTCG
ACTTCAGTCCC -> CTTCAGTCCCT
ACTTGACATAC -> CTTGACATACT
AGAAAACGTCA -> GAAAACGTCAT
AGAAAAGCGTG -> GAAAAGCGTGT
AGAACAAGCCA -> GAACAAGCCAC
AGAACGCTGAT -> GAACGCTGATT
AGAAGTGCGCG -> GAAGTGCGCGT
AGAAGTTCCCT -> GAAGTTCCCTA
AGAATCGTCGA -> GAATCGTCGAG
AGAATGCGCTA -> GAATGCGCTAG
AGAATTACTAG -> GAATTACTAGT
AGAATTTTGGT -> GAATTTTGGTA
AGACACGGGTG -> GACACGGGTGT
AGACGTCCTGT -> GACGTCCTGTG
AGATCAGCCAT -> GATCAGCCATA
AGATGTTCGCA -> GATGTTCGCAG
AGATTGACTGA -> GATTGACTGAC
AGATTTATGCG -> GATTTATGCGA
AGCAAACATGT -> GCAAACATGTT
AGCAGGTCGAT -> GCAGGTCGATA
AGCATAATATT -> GCATAATATTT
AGCATGAGGCA -> GCATGAGGCAA
AGCATTTTCGT -> GCATTTTCGTT
AGCCACGCATC -> GCCACGCATCA
AGCCATACGTG -> GCCATACGTGA
AGCCATTCAGT -> GCCATTCAGTT
AGCCCCTTCAG -> GCCCCTTCAGA
AGCCCTTTGTC -> GCCCTTTGTCG
AGCCTCAGATG -> GCCTCAGATGT
AGCCTCGAATC -> GCCTCGAATCC
AGCCTGCATTC -> GCCTGCATTCG
AGCGAACTACT -> GCGAACTACTT
AGCGACTGCAG -> GCGACTGCAGT
AGCGCTTCGAA -> GCGCTTCGAAC
AGCGGCTTAGC -> GCGGCTTAGCA
AGCGTGATTGA -> GCGTGATTGAT
AGCGTGTCTGG -> GCGTGTCTGGA
AGCTCTGCCAG -> GCTCTGCCAGG
AGCTGACCGAG -> GCTGACCGAGT
AGCTGAGCTGA -> GCTGAGCTGAC
AGCTGTTACAA -> GCTGTTACAAT
AGCTTCTCATA -> GCTTCTCATAG
AGCTTGTGAAC -> GCTTGTGAACA
AGCTTTGGAGG -> GCTTTGGAGGT
AGGAAAAAGAA -> GGAAAAAGAAA
AGGAATTCGGA -> GGAATTCGGAT
AGGACCCTCTA -> GGACCCTCTAC
AGGACCTCGGC -> GGACCTCGGCT
AGGACTCGATG -> GGACTCGATGT
AGGAGCATAAT -> GGAGCATAATA
AGGATGGCCCC -> GGATGGCCCCC
AGGATTGCGTC -> GGATTGCGTCC
AGGCAAACTAT -> GGCAAACTATG
AGGCAAAGGTT -> GGCAAAGGTTT
AGGCACACTGG -> GGCACACTGGG
AGGCACATTAT -> GGCACATTATA
AGGCAGGGATA -> GGCAGGGATAG
AGGCATTTTAT -> GGCATTTTATG
AGGCGATGGCA -> GGCGATGGCAA
AGGCTGCTTAC -> GGCTGCTTACC
AGGCTTGGCCA -> GGCTTGGCCAC
AGGGAGGGGCG -> GGGAGGGGCGT
AGGGAGGGTCT -> GGGAGGGTCTA
AGGGATAGTGG -> GGGATAGTGGA
AGGGATCATCG -> GGGATCATCGT
AGGGGCGTGGA -> GGGGCGTGGAG
AGGGTCTACGC -> GGGTCTACGCA
AGGTCAATCCC -> GGTCAATCCCG
AGGTCGATATA -> GGTCGATATAG
AGGTGGCCGTC -> GGTGGCCGTCA
AGGTTTCATTG -> GGTTTCATTGT
AGTAAAACCCC -> GTAAAACCCCT
AGTACGATTAA -> GTACGATTAAC
AGTACGCATGG -> GTACGCATGGA
AGTAGAAAAGC -> GTAGAAAAGCG
AGTATTGCCCT -> GTATTGCCCTT
AGTCAAACTAC -> GTCAAACTACA
AGTCACGTTCG -> GTCACGTTCGG
AGTCAGGAAAA -> GTCAGGAAAAA
AGTCATGTGGC -> GTCATGTGGCT
AGTCCAATCTT -> GTCCAATCTTT
AGTCCCTAAGT -> GTCCCTAAGTT
AGTCCTCCGAC -> GTCCTCCGACA
AGTCGTCTCAA -> GTCGTCTCAAG
AGTCTTCATGA -> GTCTTCATGAA
AGTCTTCATGT -> GTCTTCATGTG
AGTCTTGTCTT -> GTCTTGTCTTA
AGTGAATTCTT -> GTGAATTCTTT
AGTGCGCGTCG -> GTGCGCGTCGG
AGTGCGTTACA -> GTGCGTTACAT
AGTGCTACGAT -> GTGCTACGATC
AGTGCTTGGGT -> GTGCTTGGGTA
AGTGGACACGT -> GTGGACACGTT
AGTGGACCGTC -> GTGGACCGTCT
AGTTAAGCTGA -> GTTAAGCTGAG
AGTTATTGTTG -> GTTATTGTTGG
AGTTCCCTAAG -> GTTCCCTAAGG
AGTTCTTATAT -> GTTCTTATATA
AGTTGACTGAG -> GTTGACTGAGA
AGTTGATTTTC -> GTTGATTTTCT
AGTTGTGCCCG -> GTTGTGCCCGA
AGTTTCTACAA -> GTTTCTACAAC
AGTTTTACCAT -> GTTTTACCATG
ATAAAGTGAAT -> TAAAGTGAATT
ATAAATAGGCA -> TAAATAGGCAA
ATAACTGCAGT -> TAACTGCAGTC
ATAACTGTCTG -> TAACTGTCTGT
ATAAGTGCGTT -> TAAGTGCGTTA
ATAAGTTGACT -> TAAGTTGACTG
ATAATATTTAG -> TAATATTTAGA
ATAATGTTATG -> TAATGTTATGC
ATACACTCTCC -> TACACTCTCCT
ATACAGATCAG -> TACAGATCAGC
ATACATTGAGA -> TACATTGAGAA
ATACCATGGCC -> TACCATGGCCC
ATACGGACGAT -> TACGGACGATT
ATACGTAGGAT -> TACGTAGGATG
ATACGTCTGTT -> TACGTCTGTTC
ATACGTGACAA -> TACGTGACAAC
ATACTACATTC -> TACTACATTCA
ATACTATCTCT -> TACTATCTCTC
ATACTCCCGTC -> TACTCCCGTCC
ATACTTGACAT -> TACTTGACATA
ATAGCTGTTAC -> TAGCTGTTACA
ATAGGCAAACT -> TAGGCAAACTA
ATAGTCACGTT -> TAGTCACGTTC
ATAGTGGACCG -> TAGTGGACCGT
ATAGTTTCTAC -> TAGTTTCTACA
ATATAAAGTGA -> TATAAAGTGAA
ATATAATGTTA -> TATAATGTTAT
ATATAGCTGTT -> TATAGCTGTTA
ATATCAATTCG -> TATCAATTCGA
ATATCTGGTGT -> TATCTGGTGTT
ATATTTAGATT -> TATTTAGATTT
ATATTTCCTGG -> TATTTCCTGGG
ATATTTTCACT -> TATTTTCACTG
ATCAAATCTCG -> TCAAATCTCGC
ATCAATTCGAC -> TCAATTCGACC
ATCAGCCATAC -> TCAGCCATACG
ATCAGGAGCAT -> TCAGGAGCATA
ATCATCGTGGA -> TCATCGTGGAT
ATCCCAACTCG -> TCCCAACTCGA
ATCCCATGAGA -> TCCCATGAGAC
ATCCCGCTTCA -> TCCCGCTTCAC
ATCCCTAATCG -> TCCCTAATCGC
ATCCCTGCTAG -> TCCCTGCTAGG
ATCGCCAACCA -> TCGCCAACCAA
ATCGCCTTCTC -> TCGCCTTCTCA
ATCGCGCGAAG -> TCGCGCGAAGT
ATCGCTATTAG -> TCGCTATTAGC
ATCGGAACGTG -> TCGGAACGTGG
ATCGGACGCAA -> TCGGACGCAAA
ATCGGATTCCA -> TCGGATTCCAT
ATCGGGCCGGT -> TCGGGCCGGTT
ATCGTCGAGGC -> TCGTCGAGGCA
ATCGTGGATTA -> TCGTGGATTAG
ATCTATCCCTA -> TCTATCCCTAA
ATCTCGCCATT -> TCTCGCCATTT
ATCTCTCCTCC -> TCTCTCCTCCT
ATCTGGTGTTA -> TCTGGTGTTAG
ATCTTTGGAAG -> TCTTTGGAAGC
ATGAAAGGCAG -> TGAAAGGCAGG
ATGACATACTT -> TGACATACTTG
ATGAGACGTCC -> TGAGACGTCCT
ATGAGGCAAAG -> TGAGGCAAAGG
ATGATACAGAT -> TGATACAGATC
ATGATTGTGCA -> TGATTGTGCAG
ATGCACCGTTA -> TGCACCGTTAA
ATGCACTATCG -> TGCACTATCGG
ATGCCGCTGCC -> TGCCGCTGCCT
ATGCGATCGCC -> TGCGATCGCCT
ATGCGCTAGTT -> TGCGCTAGTTT
ATGCTACTTCA -> TGCTACTTCAA
ATGCTCAATAA -> TGCTCAATAAA
ATGCTGCTGAG -> TGCTGCTGAGT
ATGCTGTTGCG -> TGCTGTTGCGT
ATGGAATAGTC -> TGGAATAGTCA
ATGGACTAACT -> TGGACTAACTG
ATGGCAATAAC -> TGGCAATAACT
ATGGCCCATTA -> TGGCCCATTAG
ATGGCCCCCGG -> TGGCCCCCGGT
ATGTAGGGATC -> TGTAGGGATCA
ATGTCCCTGTA -> TGTCCCTGTAG
ATGTCCGCCCG -> TGTCCGCCCGT
ATGTCGACATT -> TGTCGACATTG
ATGTCTGTGAA -> TGTCTGTGAAT
ATGTCTGTTCC -> TGTCTGTTCCG
ATGTGGCTACC -> TGTGGCTACCT
ATGTGGGCTAT -> TGTGGGCTATT
ATGTTATGCTG -> TGTTATGCTGT
ATGTTCATACG -> TGTTCATACGT
ATGTTCGCAGC -> TGTTCGCAGCG
ATGTTCGCGGA -> TGTTCGCGGAG
ATGTTGGACGC -> TGTTGGACGCC
ATGTTGTCCTC -> TGTTGTCCTCA
ATTAACTCGAC -> TTAACTCGACA
ATTACCCGTTG -> TTACCCGTTGC
ATTACTAGTGC -> TTACTAGTGCT
ATTAGACACGG -> TTAGACACGGG
ATTAGCAAACA -> TTAGCAAACAT
ATTAGTCCTCC -> TTAGTCCTCCG
ATTATAACTGC -> TTATAACTGCA
ATTATGCTCAA -> TTATGCTCAAT
ATTCAGAACAA -> TTCAGAACAAG
ATTCAGTTCTT -> TTCAGTTCTTA
ATTCATGTCCG -> TTCATGTCCGC
ATTCCATGATT -> TTCCATGATTG
ATTCCCTTATA -> TTCCCTTATAT
ATTCCGCATCG -> TTCCGCATCGC
ATTCGACCTCA -> TTCGACCTCAA
ATTCGAGTAGA -> TTCGAGTAGAA
ATTCGGATGTT -> TTCGGATGTTG
ATTCGTGCAGC -> TTCGTGCAGCT
ATTCTTTCCAC -> TTCTTTCCACT
ATTGAAAGCTT -> TTGAAAGCTTG
ATTGACTGACG -> TTGACTGACGT
ATTGAGAAGTT -> TTGAGAAGTTC
ATTGATACCAT -> TTGATACCATG
ATTGCCCTTAG -> TTGCCCTTAGC
ATTGCGCCCTT -> TTGCGCCCTTA
ATTGCGTCCGT -> TTGCGTCCGTC
ATTGGAAAAGT -> TTGGAAAAGTC
ATTGGCAACCG -> TTGGCAACCGG
ATTGGTATGTC -> TTGGTATGTCT
ATTGTCCTTAA -> TTGTCCTTAAT
ATTGTGCAGTC -> TTGTGCAGTCC
ATTGTTGGGGA -> TTGTTGGGGAC
ATTTAGATTTA -> TTTAGATTTAT
ATTTATGCGAT -> TTTATGCGATC
ATTTCCTGGGC -> TTTCCTGGGCT
ATTTGTGTGAT -> TTTGTGTGATG
ATTTTAGCCTG -> TTTTAGCCTGC
ATTTTATGTTC -> TTTTATGTTCG
ATTTTCACTGT -> TTTTCACTGTG
ATTTTCGTTCC -> TTTTCGTTCCC
ATTTTCTATTA -> TTTTCTATTAT
ATTTTGGTATA -> TTTTGGTATAC
ATTTTTTAACC -> TTTTTTAACCT
CAAAAAACTAA -> AAAAAACTAAC
CAAACATGTTG -> AAACATGTTGG
CAAACCTTTCG -> AAACCTTTCGC
CAAACTACAGT -> AAACTACAGTA
CAAACTATGCT -> AAACTATGCTA
CAAAGGTTTCA -> AAAGGTTTCAT
CAAAGTCGTCT -> AAAGTCGTCTC
CAAATCTATCC -> AAATCTATCCC
CAAATCTCGCC -> AAATCTCGCCA
CAACAAGAATT -> AACAAGAATTT
CAACACCGAAT -> AACACCGAATC
CAACAGTATTG -> AACAGTATTGC
CAACCAACCTC -> AACCAACCTCC
CAACCATTACC -> AACCATTACCC
CAACCGGGGCC -> AACCGGGGCCA
CAACCTCCTAG -> AACCTCCTAGG
CAACGGCTACT -> AACGGCTACTA
CAACTCGAATT -> AACTCGAATTC
CAAGAATCGTC -> AAGAATCGTCG
CAAGAATTTTG -> AAGAATTTTGG
CAAGCATTTTC -> AAGCATTTTCG
CAAGCCACGCA -> AAGCCACGCAT
CAAGCCCCTTC -> AAGCCCCTTCA
CAAGCGGCTTA -> AAGCGGCTTAG
CAAGGAATTCG -> AAGGAATTCGG
CAATAAATAGG -> AATAAATAGGC
CAATAACTGTC -> AATAACTGTCT
CAATACTACAT -> AATACTACATT
CAATACTCCCG -> AATACTCCCGT
CAATATTTTCA -> AATATTTTCAC
CAATCCCGCTT -> AATCCCGCTTC
CAATCGGATTC -> AATCGGATTCC
CAATCTTTGGA -> AATCTTTGGAA
CAATGACATAC -> AATGACATACT
CAATTCGACCT -> AATTCGACCTC
CACACTGCAAG -> ACACTGCAAGG
CACACTGGGAC -> ACACTGGGACC
CACATTATAAC -> ACATTATAACT
CACCGAATCGC -> ACCGAATCGCT
CACCGAGGCGA -> ACCGAGGCGAT
CACCGTTAATT -> ACCGTTAATTG
CACCTATCGGA -> ACCTATCGGAC
CACGAGAATGC -> ACGAGAATGCG
CACGCATCAGG -> ACGCATCAGGA
CACGGGACAAG -> ACGGGACAAGC
CACGGGTGTTA -> ACGGGTGTTAG
CACGTTCGGAC -> ACGTTCGGACA
CACGTTGTGGG -> ACGTTGTGGGC
CACTATCGGGC -> ACTATCGGGCC
CACTCTCCTTT -> ACTCTCCTTTA
CACTGCAAGGA -> ACTGCAAGGAA
CACTGGGACCC -> ACTGGGACCCT
CACTGTAATTT -> ACTGTAATTTG
CACTGTGCTGC -> ACTGTGCTGCG
CACTTCAGTCC -> ACTTCAGTCCC
CAGAACAAGCC -> AGAACAAGCCA
CAGAATTACTA -> AGAATTACTAG
CAGATCAGCCA -> AGATCAGCCAT
CAGATGTTCGC -> AGATGTTCGCA
CAGATTGACTG -> AGATTGACTGA
CAGCCATACGT -> AGCCATACGTG
CAGCGAACTAC -> AGCGAACTACT
CAGCGCTTCGA -> AGCGCTTCGAA
CAGCGTGATTG -> AGCGTGATTGA
CAGCTTCTCAT -> AGCTTCTCATA
CAGGAAAAAGA -> AGGAAAAAGAA
CAGGACCCTCT -> AGGACCCTCTA
CAGGAGCATAA -> AGGAGCATAAT
CAGGGAGGGTC -> AGGGAGGGTCT
CAGGGATAGTG -> AGGGATAGTGG
CAGGTCGATAT -> AGGTCGATATA
CAGTAAAACCC -> AGTAAAACCCC
CAGTACGATTA -> AGTACGATTAA
CAGTATTGCCC -> AGTATTGCCCT
CAGTCAAACTA -> AGTCAAACTAC
CAGTCATGTGG -> AGTCATGTGGC
CAGTCCAATCT -> AGTCCAATCTT
CAGTCCCTAAG -> AGTCCCTAAGT
CAGTCTTCATG -> AGTCTTCATGA
CAGTCTTGTCT -> AGTCTTGTCTT
CAGTGGACACG -> AGTGGACACGT
CAGTTCTTATA -> AGTTCTTATAT
CATAAGTTGAC -> ATAAGTTGACT
CATAATATTTA -> ATAATATTTAG
CATACACTCTC -> ATACACTCTCC
CATACATTGAG -> ATACATTGAGA
CATACGGACGA -> ATACGGACGAT
CATACGTCTGT -> ATACGTCTGTT
CATACGTGACA -> ATACGTGACAA
CATACTATCTC -> ATACTATCTCT
CATACTTGACA -> ATACTTGACAT
CATAGTTTCTA -> ATAGTTTCTAC
CATATTTCCTG -> ATATTTCCTGG
CATCAGGAGCA -> ATCAGGAGCAT
CATCGCCAACC -> ATCGCCAACCA
CATCGTGGATT -> ATCGTGGATTA
CATGAAAGGCA -> ATGAAAGGCAG
CATGAGACGTC -> ATGAGACGTCC
CATGAGGCAAA -> ATGAGGCAAAG
CATGATTGTGC -> ATGATTGTGCA
CATGCACCGTT -> ATGCACCGTTA
CATGCACTATC -> ATGCACTATCG
CATGGACTAAC -> ATGGACTAACT
CATGGCCCATT -> ATGGCCCATTA
CATGTCCCTGT -> ATGTCCCTGTA
CATGTCCGCCC -> ATGTCCGCCCG
CATGTCGACAT -> ATGTCGACATT
CATGTGGCTAC -> ATGTGGCTACC
CATGTGGGCTA -> ATGTGGGCTAT
CATGTTCATAC -> ATGTTCATACG
CATGTTGGACG -> ATGTTGGACGC
CATTACCCGTT -> ATTACCCGTTG
CATTAGTCCTC -> ATTAGTCCTCC
CATTATAACTG -> ATTATAACTGC
CATTCAGAACA -> ATTCAGAACAA
CATTCAGTTCT -> ATTCAGTTCTT
CATTCATGTCC -> ATTCATGTCCG
CATTCGTGCAG -> ATTCGTGCAGC
CATTGAGAAGT -> ATTGAGAAGTT
CATTGCGCCCT -> ATTGCGCCCTT
CATTGTCCTTA -> ATTGTCCTTAA
CATTTTATGTT -> ATTTTATGTTC
CATTTTCGTTC -> ATTTTCGTTCC
CATTTTTTAAC -> ATTTTTTAACC
CCAACCAACCT -> CAACCAACCTC
CCAACCTCCTA -> CAACCTCCTAG
CCAACTCGAAT -> CAACTCGAATT
CCAATCTTTGG -> CAATCTTTGGA
CCACACTGCAA -> CACACTGCAAG
CCACCGAGGCG -> CACCGAGGCGA
CCACGCATCAG -> CACGCATCAGG
CCACGGGACAA -> CACGGGACAAG
CCACTTCAGTC -> CACTTCAGTCC
CCAGAATTACT -> CAGAATTACTA
CCAGGACCCTC -> CAGGACCCTCT
CCAGGGAGGGT -> CAGGGAGGGTC
CCATAAGTTGA -> CATAAGTTGAC
CCATACGTGAC -> CATACGTGACA
CCATGAGACGT -> CATGAGACGTC
CCATGATTGTG -> CATGATTGTGC
CCATGCACTAT -> CATGCACTATC
CCATGGCCCAT -> CATGGCCCATT
CCATGTCCCTG -> CATGTCCCTGT
CCATGTTCATA -> CATGTTCATAC
CCATTACCCGT -> CATTACCCGTT
CCATTAGTCCT -> CATTAGTCCTC
CCATTCAGTTC -> CATTCAGTTCT
CCATTTTTTAA -> CATTTTTTAAC
CCCAACTCGAA -> CCAACTCGAAT
CCCACCGAGGC -> CCACCGAGGCG
CCCATGAGACG -> CCATGAGACGT
CCCATTAGTCC -> CCATTAGTCCT
CCCCCGGTCAC -> CCCCGGTCACC
CCCCGGCCTAC -> CCCGGCCTACC
CCCCGGTCACC -> CCCGGTCACCT
CCCCTTCAGAT -> CCCTTCAGATT
CCCCTTTGCGC -> CCCTTTGCGCG
CCCGAGGCATT -> CCGAGGCATTT
CCCGCCATGCA -> CCGCCATGCAC
CCCGCTTCACT -> CCGCTTCACTG
CCCGGCCTACC -> CCGGCCTACCT
CCCGGTCACCT -> CCGGTCACCTA
CCCGTCCGTTT -> CCGTCCGTTTG
CCCGTGGAACT -> CCGTGGAACTT
CCCGTTGCCCA -> CCGTTGCCCAC
CCCTAAGGGAG -> CCTAAGGGAGG
CCCTAAGTTGA -> CCTAAGTTGAT
CCCTAATCGCG -> CCTAATCGCGC
CCCTCTACATA -> CCTCTACATAC
CCCTGCTAACG -> CCTGCTAACGG
CCCTGCTAGGA -> CCTGCTAGGAC
CCCTGTAGCCT -> CCTGTAGCCTC
CCCTTAGCATG -> CCTTAGCATGA
CCCTTAGTGCT -> CCTTAGTGCTA
CCCTTATATAA -> CCTTATATAAA
CCCTTCAGATT -> CCTTCAGATTG
CCCTTTGCGCG -> CCTTTGCGCGG
CCCTTTGTCGA -> CCTTTGTCGAT
CCGAATCGCTA -> CGAATCGCTAT
CCGACAATGAC -> CGACAATGACA
CCGAGGCATTT -> CGAGGCATTTT
CCGAGGCGATG -> CGAGGCGATGG
CCGAGTTATTG -> CGAGTTATTGT
CCGATCCCTGC -> CGATCCCTGCT
CCGATGCTGCT -> CGATGCTGCTG
CCGCATCGCCA -> CGCATCGCCAA
CCGCCATGCAC -> CGCCATGCACT
CCGCCCGTGGA -> CGCCCGTGGAA
CCGCTGCCTGG -> CGCTGCCTGGG
CCGCTTCACTG -> CGCTTCACTGT
CCGGCCTACCT -> CGGCCTACCTT
CCGGGGCCATG -> CGGGGCCATGT
CCGGTATGCCG -> CGGTATGCCGC
CCGGTCAATAT -> CGGTCAATATT
CCGGTCACCTA -> CGGTCACCTAT
CCGGTTTTTCG -> CGGTTTTTCGG
CCGTCAGTCAA -> CGTCAGTCAAA
CCGTCATGCAC -> CGTCATGCACC
CCGTCCACGGG -> CGTCCACGGGA
CCGTCCGTTTG -> CGTCCGTTTGG
CCGTCTAGTTA -> CGTCTAGTTAA
CCGTGGAACTT -> CGTGGAACTTA
CCGTTAATTGG -> CGTTAATTGGA
CCGTTGCCCAC -> CGTTGCCCACC
CCGTTTGGGAG -> CGTTTGGGAGG
CCTAAGAAGTG -> CTAAGAAGTGC
CCTAAGGGAGG -> CTAAGGGAGGG
CCTAAGTTGAT -> CTAAGTTGATT
CCTAATCGCGC -> CTAATCGCGCG
CCTACAGTACG -> CTACAGTACGA
CCTACCTTCCT -> CTACCTTCCTT
CCTAGGCACAT -> CTAGGCACATT
CCTATCGGACG -> CTATCGGACGC
CCTCAATACTA -> CTCAATACTAC
CCTCAGATGTT -> CTCAGATGTTC
CCTCATGCAAG -> CTCATGCAAGT
CCTCCAGAATT -> CTCCAGAATTA
CCTCCGACAAT -> CTCCGACAATG
CCTCCGTCATG -> CTCCGTCATGC
CCTCCTAGGCA -> CTCCTAGGCAC
CCTCCTTTGTC -> CTCCTTTGTCA
CCTCGAATCCC -> CTCGAATCCCA
CCTCGGCTCCT -> CTCGGCTCCTC
CCTCTACATAC -> CTCTACATACA
CCTGCAAGAAT -> CTGCAAGAATC
CCTGCATTCGT -> CTGCATTCGTG
CCTGCTAACGG -> CTGCTAACGGA
CCTGCTAGGAC -> CTGCTAGGACC
CCTGGAAACAT -> CTGGAAACATA
CCTGGGCTTCT -> CTGGGCTTCTT
CCTGGGTGTAC -> CTGGGTGTACA
CCTGTAGCCTC -> CTGTAGCCTCG
CCTGTGTGAAT -> CTGTGTGAATC
CCTTAATGGAA -> CTTAATGGAAT
CCTTACTACTA -> CTTACTACTAA
CCTTAGCATGA -> CTTAGCATGAG
CCTTAGTGCTA -> CTTAGTGCTAC
CCTTATATAAA -> CTTATATAAAG
CCTTCAGATTG -> CTTCAGATTGA
CCTTCCTTGCG -> CTTCCTTGCGA
CCTTCTCAAAC -> CTTCTCAAACC
CCTTGCGAATT -> CTTGCGAATTC
CCTTTATATCA -> CTTTATATCAA
CCTTTCGCCTA -> CTTTCGCCTAA
CCTTTGCGCGG -> CTTTGCGCGGC
CCTTTGTCACG -> CTTTGTCACGA
CCTTTGTCGAT -> CTTTGTCGATA
CGAACAAGCGG -> GAACAAGCGGC
CGAACTACTTA -> GAACTACTTAC
CGAAGTACGCA -> GAAGTACGCAT
CGAATCCCATG -> GAATCCCATGA
CGAATCGCTAT -> GAATCGCTATT
CGAATTCCGCA -> GAATTCCGCAT
CGAATTCGAGT -> GAATTCGAGTA
CGACAATGACA -> GACAATGACAT
CGACATATTTC -> GACATATTTCC
CGACATTGCGC -> GACATTGCGCC
CGACCTCAATA -> GACCTCAATAC
CGACGAGCCAT -> GACGAGCCATT
CGACTGCAGTG -> GACTGCAGTGG
CGAGAATGCGC -> GAGAATGCGCT
CGAGCCATTCA -> GAGCCATTCAG
CGAGGCACACT -> GAGGCACACTG
CGAGGCATTTT -> GAGGCATTTTA
CGAGGCGATGG -> GAGGCGATGGC
CGAGTAGAAAA -> GAGTAGAAAAG
CGAGTTATTGT -> GAGTTATTGTT
CGATATAGCTG -> GATATAGCTGT
CGATATCTGGT -> GATATCTGGTG
CGATCCCAACT -> GATCCCAACTC
CGATCCCTGCT -> GATCCCTGCTA
CGATCGCCTTC -> GATCGCCTTCT
CGATGCTGCTG -> GATGCTGCTGA
CGATGGCAATA -> GATGGCAATAA
CGATGTAGGGA -> GATGTAGGGAT
CGATTAACTCG -> GATTAACTCGA
CGATTGGTATG -> GATTGGTATGT
CGCAAAAAACT -> GCAAAAAACTA
CGCAGCGCTTC -> GCAGCGCTTCG
CGCAGCGTGAT -> GCAGCGTGATT
CGCATCAGGAG -> GCATCAGGAGC
CGCATCGCCAA -> GCATCGCCAAC
CGCATGGACTA -> GCATGGACTAA
CGCCAACCAAC -> GCCAACCAACC
CGCCATGCACT -> GCCATGCACTA
CGCCATTTTTT -> GCCATTTTTTA
CGCCCGTGGAA -> GCCCGTGGAAC
CGCCCTTAGTG -> GCCCTTAGTGC
CGCCTAAGAAG -> GCCTAAGAAGT
CGCCTACAGTA -> GCCTACAGTAC
CGCCTGGAAAC -> GCCTGGAAACA
CGCCTTCTCAA -> GCCTTCTCAAA
CGCGAAGTACG -> GCGAAGTACGC
CGCGCGAAGTA -> GCGCGAAGTAC
CGCGGAGGACT -> GCGGAGGACTC
CGCGGCGCTCA -> GCGGCGCTCAA
CGCGTCGGCCG -> GCGTCGGCCGG
CGCTAGTTTTA -> GCTAGTTTTAC
CGCTATTAGCA -> GCTATTAGCAA
CGCTCAAATCT -> GCTCAAATCTA
CGCTGATTCCC -> GCTGATTCCCT
CGCTGCCTGGG -> GCTGCCTGGGT
CGCTTCACTGT -> GCTTCACTGTA
CGCTTCGAACA -> GCTTCGAACAA
CGGAACGTGGG -> GGAACGTGGGC
CGGACAGTCAT -> GGACAGTCATG
CGGACGATTGG -> GGACGATTGGT
CGGACGCAAAA -> GGACGCAAAAA
CGGACTGATCG -> GGACTGATCGG
CGGAGCCTCAG -> GGAGCCTCAGA
CGGAGGACTCG -> GGAGGACTCGA
CGGATGTTGTC -> GGATGTTGTCC
CGGATTCCATG -> GGATTCCATGA
CGGCCGGTATG -> GGCCGGTATGC
CGGCCTACCTT -> GGCCTACCTTC
CGGCGCTCAAA -> GGCGCTCAAAT
CGGCTACTAGC -> GGCTACTAGCG
CGGCTCCTCCA -> GGCTCCTCCAG
CGGCTTAGCAG -> GGCTTAGCAGG
CGGGAAAATTG -> GGGAAAATTGG
CGGGACAAGCC -> GGGACAAGCCC
CGGGCCGGTTT -> GGGCCGGTTTT
CGGGGCCATGT -> GGGGCCATGTC
CGGGTGTTAGG -> GGGTGTTAGGC
CGGTATGCCGC -> GGTATGCCGCT
CGGTCAATATT -> GGTCAATATTT
CGGTCACCTAT -> GGTCACCTATC
CGGTTTTTCGG -> GGTTTTTCGGG
CGTAGGATGGC -> GTAGGATGGCC
CGTCAGTCAAA -> GTCAGTCAAAC
CGTCATGCACC -> GTCATGCACCG
CGTCATTCAGA -> GTCATTCAGAA
CGTCCACGGGA -> GTCCACGGGAC
CGTCCGTCCAC -> GTCCGTCCACG
CGTCCGTTTGG -> GTCCGTTTGGG
CGTCCTGTGTG -> GTCCTGTGTGA
CGTCGAGGCAC -> GTCGAGGCACA
CGTCGGCCGGT -> GTCGGCCGGTA
CGTCTAGTTAA -> GTCTAGTTAAG
CGTCTCAAGCA -> GTCTCAAGCAT
CGTCTGTTCCA -> GTCTGTTCCAT
CGTCTTCTCCG -> GTCTTCTCCGA
CGTGACAACGG -> GTGACAACGGC
CGTGATTGATA -> GTGATTGATAC
CGTGCAACACC -> GTGCAACACCG
CGTGCAGCTTC -> GTGCAGCTTCT
CGTGGAACTTA -> GTGGAACTTAA
CGTGGAGCCCT -> GTGGAGCCCTT
CGTGGATTAGA -> GTGGATTAGAC
CGTGGCATACA -> GTGGCATACAT
CGTGGGCGACG -> GTGGGCGACGA
CGTGTCTGGAC -> GTGTCTGGACA
CGTTAATTGGA -> GTTAATTGGAA
CGTTACATGTC -> GTTACATGTCG
CGTTCCCCGGC -> GTTCCCCGGCC
CGTTCGGACAG -> GTTCGGACAGT
CGTTGCCCACC -> GTTGCCCACCG
CGTTGTGGGCT -> GTTGTGGGCTG
CGTTTGGGAGG -> GTTTGGGAGGA
CTAACGGACTG -> TAACGGACTGA
CTAACGGAGCC -> TAACGGAGCCT
CTAACTGGTAC -> TAACTGGTACT
CTAAGAAGTGC -> TAAGAAGTGCG
CTAAGCTCTGC -> TAAGCTCTGCC
CTAAGGGAGGG -> TAAGGGAGGGG
CTAAGTTGATT -> TAAGTTGATTT
CTAATCGCGCG -> TAATCGCGCGA
CTACAACAAGA -> TACAACAAGAA
CTACAGTAAAA -> TACAGTAAAAC
CTACAGTACGA -> TACAGTACGAT
CTACATACACT -> TACATACACTC
CTACATTCATG -> TACATTCATGT
CTACCTCCGTC -> TACCTCCGTCA
CTACCTTCCTT -> TACCTTCCTTG
CTACGATCCCA -> TACGATCCCAA
CTACGCAGCGC -> TACGCAGCGCT
CTACTAAGCTC -> TACTAAGCTCT
CTACTAGCGAC -> TACTAGCGACT
CTACTTACGCC -> TACTTACGCCT
CTACTTCAAAG -> TACTTCAAAGT
CTAGCGACTGC -> TAGCGACTGCA
CTAGGACCTCG -> TAGGACCTCGG
CTAGGCACATT -> TAGGCACATTA
CTAGTGCTTGG -> TAGTGCTTGGG
CTAGTTAAGCT -> TAGTTAAGCTG
CTAGTTTTACC -> TAGTTTTACCA
CTATCCCTAAT -> TATCCCTAATC
CTATCGGACGC -> TATCGGACGCA
CTATCGGGCCG -> TATCGGGCCGG
CTATCTCTCCT -> TATCTCTCCTC
CTATGCTACTT -> TATGCTACTTC
CTATTAGCAAA -> TATTAGCAAAC
CTATTATGCTC -> TATTATGCTCA
CTATTTTAGCC -> TATTTTAGCCT
CTCAAACCTTT -> TCAAACCTTTC
CTCAAATCTAT -> TCAAATCTATC
CTCAACCATTA -> TCAACCATTAC
CTCAAGCATTT -> TCAAGCATTTT
CTCAATAAATA -> TCAATAAATAG
CTCAATACTAC -> TCAATACTACA
CTCAGATGTTC -> TCAGATGTTCG
CTCATAGTTTC -> TCATAGTTTCT
CTCATGCAAGT -> TCATGCAAGTA
CTCCAGAATTA -> TCCAGAATTAC
CTCCCGTCCGT -> TCCCGTCCGTT
CTCCGACAATG -> TCCGACAATGA
CTCCGATCCCT -> TCCGATCCCTG
CTCCGTCATGC -> TCCGTCATGCA
CTCCTAGGCAC -> TCCTAGGCACA
CTCCTCCAGAA -> TCCTCCAGAAT
CTCCTCCTTTG -> TCCTCCTTTGT
CTCCTGCAAGA -> TCCTGCAAGAA
CTCCTTTATAT -> TCCTTTATATC
CTCCTTTGTCA -> TCCTTTGTCAC
CTCGAATCCCA -> TCGAATCCCAT
CTCGAATTCCG -> TCGAATTCCGC
CTCGACATATT -> TCGACATATTT
CTCGATGTAGG -> TCGATGTAGGG
CTCGCCATTTT -> TCGCCATTTTT
CTCGGCTCCTC -> TCGGCTCCTCC
CTCTACATACA -> TCTACATACAC
CTCTCCTCCTT -> TCTCCTCCTTT
CTCTCCTTTAT -> TCTCCTTTATA
CTCTGCCAGGG -> TCTGCCAGGGA
CTGACCGAGTT -> TGACCGAGTTA
CTGACGTGCAA -> TGACGTGCAAC
CTGAGAACGCT -> TGAGAACGCTG
CTGAGCTGACC -> TGAGCTGACCG
CTGAGTCTTCA -> TGAGTCTTCAT
CTGATCGGAAC -> TGATCGGAACG
CTGATTCCCTT -> TGATTCCCTTA
CTGCAAGAATC -> TGCAAGAATCG
CTGCAAGGAAT -> TGCAAGGAATT
CTGCAGTCTTC -> TGCAGTCTTCA
CTGCAGTGGAC -> TGCAGTGGACA
CTGCATTCGTG -> TGCATTCGTGC
CTGCCAGGGAG -> TGCCAGGGAGG
CTGCCTGGGTG -> TGCCTGGGTGT
CTGCGTGGCAT -> TGCGTGGCATA
CTGCTAACGGA -> TGCTAACGGAC
CTGCTAGGACC -> TGCTAGGACCT
CTGCTGAGTCT -> TGCTGAGTCTT
CTGCTTACCGA -> TGCTTACCGAT
CTGGAAACATA -> TGGAAACATAC
CTGGACAGTCT -> TGGACAGTCTT
CTGGGACCCTG -> TGGGACCCTGC
CTGGGATTGAA -> TGGGATTGAAA
CTGGGCTTCTT -> TGGGCTTCTTT
CTGGGTGTACA -> TGGGTGTACAG
CTGGTACTCCT -> TGGTACTCCTG
CTGGTGTTAGG -> TGGTGTTAGGC
CTGTAATTTGT -> TGTAATTTGTG
CTGTAGCCTCG -> TGTAGCCTCGA
CTGTCTGTTCC -> TGTCTGTTCCC
CTGTGAATGAT -> TGTGAATGATA
CTGTGCTGCGT -> TGTGCTGCGTG
CTGTGTGAATC -> TGTGTGAATCA
CTGTTACAATC -> TGTTACAATCG
CTGTTCCATAA -> TGTTCCATAAG
CTGTTCCCGCC -> TGTTCCCGCCA
CTGTTCCGGTC -> TGTTCCGGTCA
CTGTTGCGTCT -> TGTTGCGTCTT
CTTAATAAGTG -> TTAATAAGTGC
CTTAATGGAAT -> TTAATGGAATA
CTTACCGATGC -> TTACCGATGCT
CTTACGCCTAC -> TTACGCCTACA
CTTACTACTAA -> TTACTACTAAG
CTTAGCAGGTC -> TTAGCAGGTCG
CTTAGCATGAG -> TTAGCATGAGG
CTTAGTGCTAC -> TTAGTGCTACG
CTTAGTTGTGC -> TTAGTTGTGCC
CTTATATAAAG -> TTATATAAAGT
CTTATATAATG -> TTATATAATGT
CTTCAAAGTCG -> TTCAAAGTCGT
CTTCACTGTAA -> TTCACTGTAAT
CTTCAGATTGA -> TTCAGATTGAC
CTTCAGTCCCT -> TTCAGTCCCTA
CTTCATGAAAG -> TTCATGAAAGG
CTTCATGTGGG -> TTCATGTGGGC
CTTCCTTGCGA -> TTCCTTGCGAA
CTTCGAACAAG -> TTCGAACAAGC
CTTCTCAAACC -> TTCTCAAACCT
CTTCTCATAGT -> TTCTCATAGTT
CTTCTCCGATC -> TTCTCCGATCC
CTTCTTTGCCA -> TTCTTTGCCAG
CTTGACATACT -> TTGACATACTA
CTTGCGAATTC -> TTGCGAATTCG
CTTGGCCACAC -> TTGGCCACACT
CTTGGGTAAGG -> TTGGGTAAGGT
CTTGTCTTAGT -> TTGTCTTAGTT
CTTGTGAACAA -> TTGTGAACAAC
CTTTATATCAA -> TTTATATCAAT
CTTTCCACTTC -> TTTCCACTTCA
CTTTCGCCTAA -> TTTCGCCTAAG
CTTTGCCAGGA -> TTTGCCAGGAC
CTTTGCGCGGC -> TTTGCGCGGCG
CTTTGGAAGCT -> TTTGGAAGCTT
CTTTGGAGGTG -> TTTGGAGGTGG
CTTTGTCACGA -> TTTGTCACGAG
CTTTGTCGATA -> TTTGTCGATAT
GAAAAAGAAAA -> AAAAAGAAAAC
GAAAACGTCAT -> AAAACGTCATT
GAAAAGCGTGT -> AAAAGCGTGTC
GAAAAGTCAGG -> AAAAGTCAGGA
GAAAATTGGCA -> AAAATTGGCAA
GAAACATACGG -> AAACATACGGA
GAAAGCTTGTG -> AAAGCTTGTGA
GAAAGGCAGGG -> AAAGGCAGGGA
GAACAACAGTA -> AACAACAGTAT
GAACAAGCCAC -> AACAAGCCACG
GAACAAGCGGC -> AACAAGCGGCT
GAACGCTGATT -> AACGCTGATTC
GAACGTGGGCG -> AACGTGGGCGA
GAACTACTTAC -> AACTACTTACG
GAACTTAATAA -> AACTTAATAAG
GAAGCTTTGGA -> AAGCTTTGGAG
GAAGTACGCAT -> AAGTACGCATG
GAAGTGCGCGT -> AAGTGCGCGTC
GAAGTTCCCTA -> AAGTTCCCTAA
GAATAGTCACG -> AATAGTCACGT
GAATCAAATCT -> AATCAAATCTC
GAATCCCATGA -> AATCCCATGAG
GAATCGCTATT -> AATCGCTATTA
GAATCGTCGAG -> AATCGTCGAGG
GAATGATACAG -> AATGATACAGA
GAATGCGCTAG -> AATGCGCTAGT
GAATTACTAGT -> AATTACTAGTG
GAATTCCGCAT -> AATTCCGCATC
GAATTCGAGTA -> AATTCGAGTAG
GAATTCGGATG -> AATTCGGATGT
GAATTCTTTCC -> AATTCTTTCCA
GAATTTTGGTA -> AATTTTGGTAT
GACAACGGCTA -> ACAACGGCTAC
GACAAGCCCCT -> ACAAGCCCCTT
GACAATACTCC -> ACAATACTCCC
GACAATGACAT -> ACAATGACATA
GACACGGGTGT -> ACACGGGTGTT
GACACGTTGTG -> ACACGTTGTGG
GACAGTCATGT -> ACAGTCATGTG
GACAGTCTTGT -> ACAGTCTTGTC
GACATACTATC -> ACATACTATCT
GACATACTTGA -> ACATACTTGAC
GACATATTTCC -> ACATATTTCCT
GACATTGCGCC -> ACATTGCGCCC
GACCCTCTACA -> ACCCTCTACAT
GACCCTGCTAA -> ACCCTGCTAAC
GACCGAGTTAT -> ACCGAGTTATT
GACCGTCTAGT -> ACCGTCTAGTT
GACCTCAATAC -> ACCTCAATACT
GACCTCGGCTC -> ACCTCGGCTCC
GACGAGCCATT -> ACGAGCCATTC
GACGATTGGTA -> ACGATTGGTAT
GACGCAAAAAA -> ACGCAAAAAAC
GACGCCTGGAA -> ACGCCTGGAAA
GACGTCCTGTG -> ACGTCCTGTGT
GACGTGCAACA -> ACGTGCAACAC
GACTAACTGGT -> ACTAACTGGTA
GACTCGATGTA -> ACTCGATGTAG
GACTGACGTGC -> ACTGACGTGCA
GACTGAGAACG -> ACTGAGAACGC
GACTGATCGGA -> ACTGATCGGAA
GACTGCAGTGG -> ACTGCAGTGGA
GAGAACGCTGA -> AGAACGCTGAT
GAGAAGTTCCC -> AGAAGTTCCCT
GAGAATGCGCT -> AGAATGCGCTA
GAGACGTCCTG -> AGACGTCCTGT
GAGCATAATAT -> AGCATAATATT
GAGCCATTCAG -> AGCCATTCAGT
GAGCCCTTTGT -> AGCCCTTTGTC
GAGCCTCAGAT -> AGCCTCAGATG
GAGCTGACCGA -> AGCTGACCGAG
GAGGACTCGAT -> AGGACTCGATG
GAGGATTGCGT -> AGGATTGCGTC
GAGGCAAAGGT -> AGGCAAAGGTT
GAGGCACACTG -> AGGCACACTGG
GAGGCATTTTA -> AGGCATTTTAT
GAGGCGATGGC -> AGGCGATGGCA
GAGGGGCGTGG -> AGGGGCGTGGA
GAGGGTCTACG -> AGGGTCTACGC
GAGGTGGCCGT -> AGGTGGCCGTC
GAGTAGAAAAG -> AGTAGAAAAGC
GAGTCTTCATG -> AGTCTTCATGT
GAGTTATTGTT -> AGTTATTGTTG
GATACAGATCA -> ATACAGATCAG
GATACCATGGC -> ATACCATGGCC
GATAGTGGACC -> ATAGTGGACCG
GATATAGCTGT -> ATATAGCTGTT
GATATCTGGTG -> ATATCTGGTGT
GATCAGCCATA -> ATCAGCCATAC
GATCATCGTGG -> ATCATCGTGGA
GATCCCAACTC -> ATCCCAACTCG
GATCCCTGCTA -> ATCCCTGCTAG
GATCGCCTTCT -> ATCGCCTTCTC
GATCGGAACGT -> ATCGGAACGTG
GATGCTGCTGA -> ATGCTGCTGAG
GATGGCAATAA -> ATGGCAATAAC
GATGGCCCCCG -> ATGGCCCCCGG
GATGTAGGGAT -> ATGTAGGGATC
GATGTCTGTGA -> ATGTCTGTGAA
GATGTTCGCAG -> ATGTTCGCAGC
GATGTTGTCCT -> ATGTTGTCCTC
GATTAACTCGA -> ATTAACTCGAC
GATTAGACACG -> ATTAGACACGG
GATTCCATGAT -> ATTCCATGATT
GATTCCCTTAT -> ATTCCCTTATA
GATTGAAAGCT -> ATTGAAAGCTT
GATTGACTGAC -> ATTGACTGACG
GATTGATACCA -> ATTGATACCAT
GATTGCGTCCG -> ATTGCGTCCGT
GATTGGTATGT -> ATTGGTATGTC
GATTGTGCAGT -> ATTGTGCAGTC
GATTTATGCGA -> ATTTATGCGAT
GATTTTCTATT -> ATTTTCTATTA
GCAAAAAACTA -> CAAAAAACTAA
GCAAACATGTT -> CAAACATGTTG
GCAAACTATGC -> CAAACTATGCT
GCAAAGGTTTC -> CAAAGGTTTCA
GCAACACCGAA -> CAACACCGAAT
GCAACCGGGGC -> CAACCGGGGCC
GCAAGAATCGT -> CAAGAATCGTC
GCAAGGAATTC -> CAAGGAATTCG
GCAATAACTGT -> CAATAACTGTC
GCACACTGGGA -> CACACTGGGAC
GCACATTATAA -> CACATTATAAC
GCACCGTTAAT -> CACCGTTAATT
GCACTATCGGG -> CACTATCGGGC
GCAGCGCTTCG -> CAGCGCTTCGA
GCAGCGTGATT -> CAGCGTGATTG
GCAGCTTCTCA -> CAGCTTCTCAT
GCAGGGATAGT -> CAGGGATAGTG
GCAGGTCGATA -> CAGGTCGATAT
GCAGTCCAATC -> CAGTCCAATCT
GCAGTCTTCAT -> CAGTCTTCATG
GCAGTGGACAC -> CAGTGGACACG
GCATAATATTT -> CATAATATTTA
GCATACATTGA -> CATACATTGAG
GCATCAGGAGC -> CATCAGGAGCA
GCATCGCCAAC -> CATCGCCAACC
GCATGAGGCAA -> CATGAGGCAAA
GCATGGACTAA -> CATGGACTAAC
GCATTCGTGCA -> CATTCGTGCAG
GCATTTTATGT -> CATTTTATGTT
GCATTTTCGTT -> CATTTTCGTTC
GCCAACCAACC -> CCAACCAACCT
GCCACACTGCA -> CCACACTGCAA
GCCACGCATCA -> CCACGCATCAG
GCCAGGACCCT -> CCAGGACCCTC
GCCAGGGAGGG -> CCAGGGAGGGT
GCCATACGTGA -> CCATACGTGAC
GCCATGCACTA -> CCATGCACTAT
GCCATGTCCCT -> CCATGTCCCTG
GCCATTCAGTT -> CCATTCAGTTC
GCCATTTTTTA -> CCATTTTTTAA
GCCCACCGAGG -> CCCACCGAGGC
GCCCATTAGTC -> CCCATTAGTCC
GCCCCCGGTCA -> CCCCCGGTCAC
GCCCCTTCAGA -> CCCCTTCAGAT
GCCCGAGGCAT -> CCCGAGGCATT
GCCCGTGGAAC -> CCCGTGGAACT
GCCCTTAGCAT -> CCCTTAGCATG
GCCCTTAGTGC -> CCCTTAGTGCT
GCCCTTTGTCG -> CCCTTTGTCGA
GCCGCTGCCTG -> CCGCTGCCTGG
GCCGGTATGCC -> CCGGTATGCCG
GCCGGTTTTTC -> CCGGTTTTTCG
GCCGTCAGTCA -> CCGTCAGTCAA
GCCTAAGAAGT -> CCTAAGAAGTG
GCCTACAGTAC -> CCTACAGTACG
GCCTACCTTCC -> CCTACCTTCCT
GCCTCAGATGT -> CCTCAGATGTT
GCCTCGAATCC -> CCTCGAATCCC
GCCTGCATTCG -> CCTGCATTCGT
GCCTGGAAACA -> CCTGGAAACAT
GCCTGGGTGTA -> CCTGGGTGTAC
GCCTTCTCAAA -> CCTTCTCAAAC
GCGAACTACTT -> CGAACTACTTA
GCGAAGTACGC -> CGAAGTACGCA
GCGAATTCGAG -> CGAATTCGAGT
GCGACGAGCCA -> CGACGAGCCAT
GCGACTGCAGT -> CGACTGCAGTG
GCGATCGCCTT -> CGATCGCCTTC
GCGATGGCAAT -> CGATGGCAATA
GCGCCCTTAGT -> CGCCCTTAGTG
GCGCGAAGTAC -> CGCGAAGTACG
GCGCGGCGCTC -> CGCGGCGCTCA
GCGCGTCGGCC -> CGCGTCGGCCG
GCGCTAGTTTT -> CGCTAGTTTTA
GCGCTCAAATC -> CGCTCAAATCT
GCGCTTCGAAC -> CGCTTCGAACA
GCGGAGGACTC -> CGGAGGACTCG
GCGGCGCTCAA -> CGGCGCTCAAA
GCGGCTTAGCA -> CGGCTTAGCAG
GCGTCCGTCCA -> CGTCCGTCCAC
GCGTCGGCCGG -> CGTCGGCCGGT
GCGTCTTCTCC -> CGTCTTCTCCG
GCGTGATTGAT -> CGTGATTGATA
GCGTGGAGCCC -> CGTGGAGCCCT
GCGTGGCATAC -> CGTGGCATACA
GCGTGTCTGGA -> CGTGTCTGGAC
GCGTTACATGT -> CGTTACATGTC
GCTAACGGACT -> CTAACGGACTG
GCTACCTCCGT -> CTACCTCCGTC
GCTACGATCCC -> CTACGATCCCA
GCTACTAGCGA -> CTACTAGCGAC
GCTACTTCAAA -> CTACTTCAAAG
GCTAGGACCTC -> CTAGGACCTCG
GCTAGTTTTAC -> CTAGTTTTACC
GCTATTAGCAA -> CTATTAGCAAA
GCTATTTTAGC -> CTATTTTAGCC
GCTCAAATCTA -> CTCAAATCTAT
GCTCAATAAAT -> CTCAATAAATA
GCTCCTCCAGA -> CTCCTCCAGAA
GCTCTGCCAGG -> CTCTGCCAGGG
GCTGACCGAGT -> CTGACCGAGTT
GCTGAGCTGAC -> CTGAGCTGACC
GCTGAGTCTTC -> CTGAGTCTTCA
GCTGATTCCCT -> CTGATTCCCTT
GCTGCCTGGGT -> CTGCCTGGGTG
GCTGCGTGGCA -> CTGCGTGGCAT
GCTGCTGAGTC -> CTGCTGAGTCT
GCTGCTTACCG -> CTGCTTACCGA
GCTGGGATTGA -> CTGGGATTGAA
GCTGTTACAAT -> CTGTTACAATC
GCTGTTGCGTC -> CTGTTGCGTCT
GCTTACCGATG -> CTTACCGATGC
GCTTAGCAGGT -> CTTAGCAGGTC
GCTTCACTGTA -> CTTCACTGTAA
GCTTCGAACAA -> CTTCGAACAAG
GCTTCTCATAG -> CTTCTCATAGT
GCTTCTTTGCC -> CTTCTTTGCCA
GCTTGGCCACA -> CTTGGCCACAC
GCTTGGGTAAG -> CTTGGGTAAGG
GCTTGTGAACA -> CTTGTGAACAA
GCTTTGGAGGT -> CTTTGGAGGTG
GGAAAAAGAAA -> GAAAAAGAAAA
GGAAAAGTCAG -> GAAAAGTCAGG
GGAAAATTGGC -> GAAAATTGGCA
GGAAACATACG -> GAAACATACGG
GGAACGTGGGC -> GAACGTGGGCG
GGAACTTAATA -> GAACTTAATAA
GGAAGCTTTGG -> GAAGCTTTGGA
GGAATAGTCAC -> GAATAGTCACG
GGAATTCGGAT -> GAATTCGGATG
GGACAAGCCCC -> GACAAGCCCCT
GGACAATACTC -> GACAATACTCC
GGACACGTTGT -> GACACGTTGTG
GGACAGTCATG -> GACAGTCATGT
GGACAGTCTTG -> GACAGTCTTGT
GGACCCTCTAC -> GACCCTCTACA
GGACCCTGCTA -> GACCCTGCTAA
GGACCGTCTAG -> GACCGTCTAGT
GGACCTCGGCT -> GACCTCGGCTC
GGACGATTGGT -> GACGATTGGTA
GGACGCAAAAA -> GACGCAAAAAA
GGACGCCTGGA -> GACGCCTGGAA
GGACTAACTGG -> GACTAACTGGT
GGACTCGATGT -> GACTCGATGTA
GGACTGATCGG -> GACTGATCGGA
GGAGCATAATA -> GAGCATAATAT
GGAGCCCTTTG -> GAGCCCTTTGT
GGAGCCTCAGA -> GAGCCTCAGAT
GGAGGACTCGA -> GAGGACTCGAT
GGAGGATTGCG -> GAGGATTGCGT
GGAGGGGCGTG -> GAGGGGCGTGG
GGAGGGTCTAC -> GAGGGTCTACG
GGAGGTGGCCG -> GAGGTGGCCGT
GGATAGTGGAC -> GATAGTGGACC
GGATCATCGTG -> GATCATCGTGG
GGATGGCCCCC -> GATGGCCCCCG
GGATGTTGTCC -> GATGTTGTCCT
GGATTAGACAC -> GATTAGACACG
GGATTCCATGA -> GATTCCATGAT
GGATTGAAAGC -> GATTGAAAGCT
GGATTGCGTCC -> GATTGCGTCCG
GGCAAACTATG -> GCAAACTATGC
GGCAAAGGTTT -> GCAAAGGTTTC
GGCAACCGGGG -> GCAACCGGGGC
GGCAATAACTG -> GCAATAACTGT
GGCACACTGGG -> GCACACTGGGA
GGCACATTATA -> GCACATTATAA
GGCAGGGATAG -> GCAGGGATAGT
GGCATACATTG -> GCATACATTGA
GGCATTTTATG -> GCATTTTATGT
GGCCACACTGC -> GCCACACTGCA
GGCCATGTCCC -> GCCATGTCCCT
GGCCCATTAGT -> GCCCATTAGTC
GGCCCCCGGTC -> GCCCCCGGTCA
GGCCGGTATGC -> GCCGGTATGCC
GGCCGGTTTTT -> GCCGGTTTTTC
GGCCGTCAGTC -> GCCGTCAGTCA
GGCCTACCTTC -> GCCTACCTTCC
GGCGACGAGCC -> GCGACGAGCCA
GGCGATGGCAA -> GCGATGGCAAT
GGCGCTCAAAT -> GCGCTCAAATC
GGCGTGGAGCC -> GCGTGGAGCCC
GGCTACCTCCG -> GCTACCTCCGT
GGCTACTAGCG -> GCTACTAGCGA
GGCTATTTTAG -> GCTATTTTAGC
GGCTCCTCCAG -> GCTCCTCCAGA
GGCTGCTTACC -> GCTGCTTACCG
GGCTGGGATTG -> GCTGGGATTGA
GGCTTAGCAGG -> GCTTAGCAGGT
GGCTTCTTTGC -> GCTTCTTTGCC
GGCTTGGCCAC -> GCTTGGCCACA
GGGAAAATTGG -> GGAAAATTGGC
GGGACAAGCCC -> GGACAAGCCCC
GGGACAATACT -> GGACAATACTC
GGGACCCTGCT -> GGACCCTGCTA
GGGAGGATTGC -> GGAGGATTGCG
GGGAGGGGCGT -> GGAGGGGCGTG
GGGAGGGTCTA -> GGAGGGTCTAC
GGGATAGTGGA -> GGATAGTGGAC
GGGATCATCGT -> GGATCATCGTG
GGGATTGAAAG -> GGATTGAAAGC
GGGCCATGTCC -> GGCCATGTCCC
GGGCCGGTTTT -> GGCCGGTTTTT
GGGCGACGAGC -> GGCGACGAGCC
GGGCGTGGAGC -> GGCGTGGAGCC
GGGCTATTTTA -> GGCTATTTTAG
GGGCTGGGATT -> GGCTGGGATTG
GGGCTTCTTTG -> GGCTTCTTTGC
GGGGACAATAC -> GGGACAATACT
GGGGCCATGTC -> GGGCCATGTCC
GGGGCGTGGAG -> GGGCGTGGAGC
GGGTAAGGTCA -> GGTAAGGTCAA
GGGTCTACGCA -> GGTCTACGCAG
GGGTGTACAGC -> GGTGTACAGCG
GGGTGTTAGGC -> GGTGTTAGGCT
GGTAAGGTCAA -> GTAAGGTCAAT
GGTACTCCTGC -> GTACTCCTGCA
GGTATACGTAG -> GTATACGTAGG
GGTATGCCGCT -> GTATGCCGCTG
GGTATGTCTGT -> GTATGTCTGTT
GGTCAATATTT -> GTCAATATTTT
GGTCAATCCCG -> GTCAATCCCGC
GGTCACCTATC -> GTCACCTATCG
GGTCGATATAG -> GTCGATATAGC
GGTCTACGCAG -> GTCTACGCAGC
GGTGGCCGTCA -> GTGGCCGTCAG
GGTGTACAGCG -> GTGTACAGCGA
GGTGTTAGGCT -> GTGTTAGGCTG,GTGTTAGGCTT
GGTTTCATTGT -> GTTTCATTGTC
GGTTTTTCGGG -> GTTTTTCGGGA
GTAAAACCCCT -> TAAAACCCCTT
GTAAGGTCAAT -> TAAGGTCAATC
GTAATTTGTGT -> TAATTTGTGTG
GTACAGCGAAC -> TACAGCGAACT
GTACGATTAAC -> TACGATTAACT
GTACGCATGGA -> TACGCATGGAC
GTACTCCTGCA -> TACTCCTGCAA
GTAGAAAAGCG -> TAGAAAAGCGT
GTAGCCTCGAA -> TAGCCTCGAAT
GTAGGATGGCC -> TAGGATGGCCC
GTAGGGATCAT -> TAGGGATCATC
GTATACGTAGG -> TATACGTAGGA
GTATGCCGCTG -> TATGCCGCTGC
GTATGTCTGTT -> TATGTCTGTTC
GTATTGCCCTT -> TATTGCCCTTA
GTCAAACTACA -> TCAAACTACAG
GTCAATATTTT -> TCAATATTTTC
GTCAATCCCGC -> TCAATCCCGCT
GTCACCTATCG -> TCACCTATCGG
GTCACGAGAAT -> TCACGAGAATG
GTCACGTTCGG -> TCACGTTCGGA
GTCAGGAAAAA -> TCAGGAAAAAG
GTCAGTCAAAC -> TCAGTCAAACT
GTCATGCACCG -> TCATGCACCGT
GTCATGTGGCT -> TCATGTGGCTA
GTCATTCAGAA -> TCATTCAGAAC
GTCCAATCTTT -> TCCAATCTTTG
GTCCACGGGAC -> TCCACGGGACA
GTCCCTAAGTT -> TCCCTAAGTTG
GTCCCTGTAGC -> TCCCTGTAGCC
GTCCGCCCGTG -> TCCGCCCGTGG
GTCCGTCCACG -> TCCGTCCACGG
GTCCGTTTGGG -> TCCGTTTGGGA
GTCCTCATGCA -> TCCTCATGCAA
GTCCTCCGACA -> TCCTCCGACAA
GTCCTGTGTGA -> TCCTGTGTGAA
GTCCTTAATGG -> TCCTTAATGGA
GTCGACATTGC -> TCGACATTGCG
GTCGAGGCACA -> TCGAGGCACAC
GTCGATATAGC -> TCGATATAGCT
GTCGATATCTG -> TCGATATCTGG
GTCGGCCGGTA -> TCGGCCGGTAT
GTCGTCTCAAG -> TCGTCTCAAGC
GTCTACGCAGC -> TCTACGCAGCG
GTCTAGTTAAG -> TCTAGTTAAGC
GTCTCAAGCAT -> TCTCAAGCATT
GTCTGGACAGT -> TCTGGACAGTC
GTCTGTGAATG -> TCTGTGAATGA
GTCTGTTCCAT -> TCTGTTCCATA
GTCTGTTCCCG -> TCTGTTCCCGC
GTCTGTTCCGG -> TCTGTTCCGGT
GTCTTAGTTGT -> TCTTAGTTGTG
GTCTTCATGAA -> TCTTCATGAAA
GTCTTCATGTG -> TCTTCATGTGG
GTCTTCTCCGA -> TCTTCTCCGAT
GTCTTGTCTTA -> TCTTGTCTTAG
GTGAACAACAG -> TGAACAACAGT
GTGAATCAAAT -> TGAATCAAATC
GTGAATGATAC -> TGAATGATACA
GTGAATTCTTT -> TGAATTCTTTC
GTGACAACGGC -> TGACAACGGCT
GTGATGTCTGT -> TGATGTCTGTG
GTGATTGATAC -> TGATTGATACC
GTGCAACACCG -> TGCAACACCGA
GTGCAGCTTCT -> TGCAGCTTCTC
GTGCAGTCCAA -> TGCAGTCCAAT
GTGCCCGAGGC -> TGCCCGAGGCA
GTGCGCGTCGG -> TGCGCGTCGGC
GTGCGTTACAT -> TGCGTTACATG
GTGCTACGATC -> TGCTACGATCC
GTGCTGCGTGG -> TGCTGCGTGGC
GTGCTTGGGTA -> TGCTTGGGTAA
GTGGAACTTAA -> TGGAACTTAAT
GTGGACACGTT -> TGGACACGTTG
GTGGACCGTCT -> TGGACCGTCTA
GTGGAGCCCTT -> TGGAGCCCTTT
GTGGATTAGAC -> TGGATTAGACA
GTGGCATACAT -> TGGCATACATT
GTGGCCGTCAG -> TGGCCGTCAGT
GTGGCTACCTC -> TGGCTACCTCC
GTGGGCGACGA -> TGGGCGACGAG
GTGGGCTATTT -> TGGGCTATTTT
GTGGGCTGGGA -> TGGGCTGGGAT
GTGTACAGCGA -> TGTACAGCGAA
GTGTCTGGACA -> TGTCTGGACAG
GTGTGAATCAA -> TGTGAATCAAA
GTGTGATGTCT -> TGTGATGTCTG
GTGTTAGGCTG -> TGTTAGGCTGC
GTGTTAGGCTT -> TGTTAGGCTTG
GTTAAGCTGAG -> TTAAGCTGAGC
GTTAATTGGAA -> TTAATTGGAAA
GTTACAATCGG -> TTACAATCGGA
GTTACATGTCG -> TTACATGTCGA
GTTAGGCTGCT -> TTAGGCTGCTT
GTTAGGCTTGG -> TTAGGCTTGGC
GTTATGCTGTT -> TTATGCTGTTG
GTTATTGTTGG -> TTATTGTTGGG
GTTCATACGTC -> TTCATACGTCT
GTTCCATAAGT -> TTCCATAAGTT
GTTCCCCGGCC -> TTCCCCGGCCT
GTTCCCGCCAT -> TTCCCGCCATG
GTTCCCTAAGG -> TTCCCTAAGGG
GTTCCGGTCAA -> TTCCGGTCAAT
GTTCGCAGCGT -> TTCGCAGCGTG
GTTCGCGGAGG -> TTCGCGGAGGA
GTTCGGACAGT -> TTCGGACAGTC
GTTCTTATATA -> TTCTTATATAA
GTTGACTGAGA -> TTGACTGAGAA
GTTGATTTTCT -> TTGATTTTCTA
GTTGCCCACCG -> TTGCCCACCGA
GTTGCGTCTTC -> TTGCGTCTTCT
GTTGGACGCCT -> TTGGACGCCTG
GTTGGGGACAA -> TTGGGGACAAT
GTTGTCCTCAT -> TTGTCCTCATG
GTTGTGCCCGA -> TTGTGCCCGAG
GTTGTGGGCTG -> TTGTGGGCTGG
GTTTCATTGTC -> TTTCATTGTCC
GTTTCTACAAC -> TTTCTACAACA
GTTTGGGAGGA -> TTTGGGAGGAT
GTTTTACCATG -> TTTTACCATGT
GTTTTTCGGGA -> TTTTTCGGGAA
TAAAACCCCTT -> AAAACCCCTTT
TAAAGTGAATT -> AAAGTGAATTC
TAAATAGGCAA -> AAATAGGCAAA
TAACCTTACTA -> AACCTTACTAC
TAACGGACTGA -> AACGGACTGAT
TAACGGAGCCT -> AACGGAGCCTC
TAACTCGACAT -> AACTCGACATA
TAACTGCAGTC -> AACTGCAGTCT
TAACTGGTACT -> AACTGGTACTC
TAACTGTCTGT -> AACTGTCTGTT
TAAGAAGTGCG -> AAGAAGTGCGC
TAAGCTCTGCC -> AAGCTCTGCCA
TAAGCTGAGCT -> AAGCTGAGCTG
TAAGGGAGGGG -> AAGGGAGGGGC
TAAGGTCAATC -> AAGGTCAATCC
TAAGTGCGTTA -> AAGTGCGTTAC
TAAGTTGACTG -> AAGTTGACTGA
TAAGTTGATTT -> AAGTTGATTTT
TAATAAGTGCG -> AATAAGTGCGT
TAATATTTAGA -> AATATTTAGAT
TAATCGCGCGA -> AATCGCGCGAA
TAATGGAATAG -> AATGGAATAGT
TAATGTTATGC -> AATGTTATGCT
TAATTGGAAAA -> AATTGGAAAAG
TAATTTGTGTG -> AATTTGTGTGA
TACAACAAGAA -> ACAACAAGAAT
TACAATCGGAT -> ACAATCGGATT
TACACTCTCCT -> ACACTCTCCTT
TACAGATCAGC -> ACAGATCAGCC
TACAGCGAACT -> ACAGCGAACTA
TACAGTAAAAC -> ACAGTAAAACC
TACAGTACGAT -> ACAGTACGATT
TACATACACTC -> ACATACACTCT
TACATGTCGAC -> ACATGTCGACA
TACATTCATGT -> ACATTCATGTC
TACATTGAGAA -> ACATTGAGAAG
TACCATGGCCC -> ACCATGGCCCA
TACCATGTTCA -> ACCATGTTCAT
TACCCGTTGCC -> ACCCGTTGCCC
TACCGATGCTG -> ACCGATGCTGC
TACCTCCGTCA -> ACCTCCGTCAT
TACCTTCCTTG -> ACCTTCCTTGC
TACGATCCCAA -> ACGATCCCAAC
TACGATTAACT -> ACGATTAACTC
TACGCAGCGCT -> ACGCAGCGCTT
TACGCATGGAC -> ACGCATGGACT
TACGCCTACAG -> ACGCCTACAGT
TACGGACGATT -> ACGGACGATTG
TACGTAGGATG -> ACGTAGGATGG
TACGTCTGTTC -> ACGTCTGTTCC
TACGTGACAAC -> ACGTGACAACG
TACTAAGCTCT -> ACTAAGCTCTG
TACTACATTCA -> ACTACATTCAT
TACTACTAAGC -> ACTACTAAGCT
TACTAGCGACT -> ACTAGCGACTG
TACTAGTGCTT -> ACTAGTGCTTG
TACTATCTCTC -> ACTATCTCTCC
TACTCCCGTCC -> ACTCCCGTCCG
TACTCCTGCAA -> ACTCCTGCAAG
TACTTACGCCT -> ACTTACGCCTA
TACTTCAAAGT -> ACTTCAAAGTC
TACTTGACATA -> ACTTGACATAC
TAGAAAAGCGT -> AGAAAAGCGTG
TAGACACGGGT -> AGACACGGGTG
TAGATTTATGC -> AGATTTATGCG
TAGCAAACATG -> AGCAAACATGT
TAGCAGGTCGA -> AGCAGGTCGAT
TAGCATGAGGC -> AGCATGAGGCA
TAGCCTCGAAT -> AGCCTCGAATC
TAGCCTGCATT -> AGCCTGCATTC
TAGCGACTGCA -> AGCGACTGCAG
TAGCTGTTACA -> AGCTGTTACAA
TAGGACCTCGG -> AGGACCTCGGC
TAGGATGGCCC -> AGGATGGCCCC
TAGGCAAACTA -> AGGCAAACTAT
TAGGCACATTA -> AGGCACATTAT
TAGGCTGCTTA -> AGGCTGCTTAC
TAGGCTTGGCC -> AGGCTTGGCCA
TAGGGATCATC -> AGGGATCATCG
TAGTCACGTTC -> AGTCACGTTCG
TAGTCCTCCGA -> AGTCCTCCGAC
TAGTGCTACGA -> AGTGCTACGAT
TAGTGCTTGGG -> AGTGCTTGGGT
TAGTGGACCGT -> AGTGGACCGTC
TAGTTAAGCTG -> AGTTAAGCTGA
TAGTTGTGCCC -> AGTTGTGCCCG
TAGTTTCTACA -> AGTTTCTACAA
TAGTTTTACCA -> AGTTTTACCAT
TATAAAGTGAA -> ATAAAGTGAAT
TATAACTGCAG -> ATAACTGCAGT
TATAATGTTAT -> ATAATGTTATG
TATACGTAGGA -> ATACGTAGGAT
TATAGCTGTTA -> ATAGCTGTTAC
TATATAAAGTG -> ATATAAAGTGA
TATATAATGTT -> ATATAATGTTA
TATATCAATTC -> ATATCAATTCG
TATCAATTCGA -> ATCAATTCGAC
TATCCCTAATC -> ATCCCTAATCG
TATCGGACGCA -> ATCGGACGCAA
TATCGGGCCGG -> ATCGGGCCGGT
TATCTCTCCTC -> ATCTCTCCTCC
TATCTGGTGTT -> ATCTGGTGTTA
TATGCCGCTGC -> ATGCCGCTGCC
TATGCGATCGC -> ATGCGATCGCC
TATGCTACTTC -> ATGCTACTTCA
TATGCTCAATA -> ATGCTCAATAA
TATGCTGTTGC -> ATGCTGTTGCG
TATGTCTGTTC -> ATGTCTGTTCC
TATGTTCGCGG -> ATGTTCGCGGA
TATTAGCAAAC -> ATTAGCAAACA
TATTATGCTCA -> ATTATGCTCAA
TATTGCCCTTA -> ATTGCCCTTAG
TATTGTTGGGG -> ATTGTTGGGGA
TATTTAGATTT -> ATTTAGATTTA
TATTTCCTGGG -> ATTTCCTGGGC
TATTTTAGCCT -> ATTTTAGCCTG
TATTTTCACTG -> ATTTTCACTGT
TCAAACCTTTC -> CAAACCTTTCG
TCAAACTACAG -> CAAACTACAGT
TCAAAGTCGTC -> CAAAGTCGTCT
TCAAATCTATC -> CAAATCTATCC
TCAAATCTCGC -> CAAATCTCGCC
TCAACCATTAC -> CAACCATTACC
TCAAGCATTTT -> CAAGCATTTTC
TCAATAAATAG -> CAATAAATAGG
TCAATACTACA -> CAATACTACAT
TCAATATTTTC -> CAATATTTTCA
TCAATCCCGCT -> CAATCCCGCTT
TCAATTCGACC -> CAATTCGACCT
TCACCTATCGG -> CACCTATCGGA
TCACGAGAATG -> CACGAGAATGC
TCACGTTCGGA -> CACGTTCGGAC
TCACTGTAATT -> CACTGTAATTT
TCACTGTGCTG -> CACTGTGCTGC
TCAGAACAAGC -> CAGAACAAGCC
TCAGATGTTCG -> CAGATGTTCGC
TCAGATTGACT -> CAGATTGACTG
TCAGCCATACG -> CAGCCATACGT
TCAGGAAAAAG -> CAGGAAAAAGA
TCAGGAGCATA -> CAGGAGCATAA
TCAGTCAAACT -> CAGTCAAACTA
TCAGTCCCTAA -> CAGTCCCTAAG
TCAGTTCTTAT -> CAGTTCTTATA
TCATACGTCTG -> CATACGTCTGT
TCATAGTTTCT -> CATAGTTTCTA
TCATCGTGGAT -> CATCGTGGATT
TCATGAAAGGC -> CATGAAAGGCA
TCATGCAAGTA -> CATGCAAGTAC
TCATGCACCGT -> CATGCACCGTT
TCATGTCCGCC -> CATGTCCGCCC
TCATGTGGCTA -> CATGTGGCTAC
TCATGTGGGCT -> CATGTGGGCTA
TCATTCAGAAC -> CATTCAGAACA
TCATTGTCCTT -> CATTGTCCTTA
TCCAATCTTTG -> CCAATCTTTGG
TCCACGGGACA -> CCACGGGACAA
TCCACTTCAGT -> CCACTTCAGTC
TCCAGAATTAC -> CCAGAATTACT
TCCATAAGTTG -> CCATAAGTTGA
TCCATGATTGT -> CCATGATTGTG
TCCCAACTCGA -> CCCAACTCGAA
TCCCATGAGAC -> CCCATGAGACG
TCCCCGGCCTA -> CCCCGGCCTAC
TCCCGCCATGC -> CCCGCCATGCA
TCCCGCTTCAC -> CCCGCTTCACT
TCCCGTCCGTT -> CCCGTCCGTTT
TCCCTAAGGGA -> CCCTAAGGGAG
TCCCTAAGTTG -> CCCTAAGTTGA
TCCCTAATCGC -> CCCTAATCGCG
TCCCTGCTAGG -> CCCTGCTAGGA
TCCCTGTAGCC -> CCCTGTAGCCT
TCCCTTATATA -> CCCTTATATAA
TCCGACAATGA -> CCGACAATGAC
TCCGATCCCTG -> CCGATCCCTGC
TCCGCATCGCC -> CCGCATCGCCA
TCCGCCCGTGG -> CCGCCCGTGGA
TCCGGTCAATA -> CCGGTCAATAT
TCCGTCATGCA -> CCGTCATGCAC
TCCGTCCACGG -> CCGTCCACGGG
TCCGTTTGGGA -> CCGTTTGGGAG
TCCTAGGCACA -> CCTAGGCACAT
TCCTCATGCAA -> CCTCATGCAAG
TCCTCCAGAAT -> CCTCCAGAATT
TCCTCCGACAA -> CCTCCGACAAT
TCCTCCTTTGT -> CCTCCTTTGTC
TCCTGCAAGAA -> CCTGCAAGAAT
TCCTGGGCTTC -> CCTGGGCTTCT
TCCTGTGTGAA -> CCTGTGTGAAT
TCCTTAATGGA -> CCTTAATGGAA
TCCTTGCGAAT -> CCTTGCGAATT
TCCTTTATATC -> CCTTTATATCA
TCCTTTGTCAC -> CCTTTGTCACG
TCGAACAAGCG -> CGAACAAGCGG
TCGAATCCCAT -> CGAATCCCATG
TCGAATTCCGC -> CGAATTCCGCA
TCGACATATTT -> CGACATATTTC
TCGACATTGCG -> CGACATTGCGC
TCGACCTCAAT -> CGACCTCAATA
TCGAGGCACAC -> CGAGGCACACT
TCGAGTAGAAA -> CGAGTAGAAAA
TCGATATAGCT -> CGATATAGCTG
TCGATATCTGG -> CGATATCTGGT
TCGATGTAGGG -> CGATGTAGGGA
TCGCAGCGTGA -> CGCAGCGTGAT
TCGCCAACCAA -> CGCCAACCAAC
TCGCCATTTTT -> CGCCATTTTTT
TCGCCTAAGAA -> CGCCTAAGAAG
TCGCCTTCTCA -> CGCCTTCTCAA
TCGCGCGAAGT -> CGCGCGAAGTA
TCGCGGAGGAC -> CGCGGAGGACT
TCGCTATTAGC -> CGCTATTAGCA
TCGGAACGTGG -> CGGAACGTGGG
TCGGACAGTCA -> CGGACAGTCAT
TCGGACGCAAA -> CGGACGCAAAA
TCGGATGTTGT -> CGGATGTTGTC
TCGGATTCCAT -> CGGATTCCATG
TCGGCCGGTAT -> CGGCCGGTATG
TCGGCTCCTCC -> CGGCTCCTCCA
TCGGGAAAATT -> CGGGAAAATTG
TCGGGCCGGTT -> CGGGCCGGTTT
TCGTCGAGGCA -> CGTCGAGGCAC
TCGTCTCAAGC -> CGTCTCAAGCA
TCGTGCAGCTT -> CGTGCAGCTTC
TCGTGGATTAG -> CGTGGATTAGA
TCGTTCCCCGG -> CGTTCCCCGGC
TCTACAACAAG -> CTACAACAAGA
TCTACATACAC -> CTACATACACT
TCTACGCAGCG -> CTACGCAGCGC
TCTAGTTAAGC -> CTAGTTAAGCT
TCTATCCCTAA -> CTATCCCTAAT
TCTATTATGCT -> CTATTATGCTC
TCTCAAACCTT -> CTCAAACCTTT
TCTCAACCATT -> CTCAACCATTA
TCTCAAGCATT -> CTCAAGCATTT
TCTCATAGTTT -> CTCATAGTTTC
TCTCCGATCCC -> CTCCGATCCCT
TCTCCTCCTTT -> CTCCTCCTTTG
TCTCCTTTATA -> CTCCTTTATAT
TCTCGCCATTT -> CTCGCCATTTT
TCTCTCCTCCT -> CTCTCCTCCTT
TCTGCCAGGGA -> CTGCCAGGGAG
TCTGGACAGTC -> CTGGACAGTCT
TCTGGTGTTAG -> CTGGTGTTAGG
TCTGTGAATGA -> CTGTGAATGAT
TCTGTTCCATA -> CTGTTCCATAA
TCTGTTCCCGC -> CTGTTCCCGCC
TCTGTTCCGGT -> CTGTTCCGGTC
TCTTAGTTGTG -> CTTAGTTGTGC
TCTTATATAAT -> CTTATATAATG
TCTTCATGAAA -> CTTCATGAAAG
TCTTCATGTGG -> CTTCATGTGGG
TCTTCTCCGAT -> CTTCTCCGATC
TCTTGTCTTAG -> CTTGTCTTAGT
TCTTTCCACTT -> CTTTCCACTTC
TCTTTGCCAGG -> CTTTGCCAGGA
TCTTTGGAAGC -> CTTTGGAAGCT
TGAAAGCTTGT -> GAAAGCTTGTG
TGAAAGGCAGG -> GAAAGGCAGGG
TGAACAACAGT -> GAACAACAGTA
TGAATCAAATC -> GAATCAAATCT
TGAATGATACA -> GAATGATACAG
TGAATTCTTTC -> GAATTCTTTCC
TGACAACGGCT -> GACAACGGCTA
TGACATACTAT -> GACATACTATC
TGACATACTTG -> GACATACTTGA
TGACCGAGTTA -> GACCGAGTTAT
TGACGTGCAAC -> GACGTGCAACA
TGACTGACGTG -> GACTGACGTGC
TGACTGAGAAC -> GACTGAGAACG
TGAGAACGCTG -> GAGAACGCTGA
TGAGAAGTTCC -> GAGAAGTTCCC
TGAGACGTCCT -> GAGACGTCCTG
TGAGCTGACCG -> GAGCTGACCGA
TGAGGCAAAGG -> GAGGCAAAGGT
TGAGTCTTCAT -> GAGTCTTCATG
TGATACAGATC -> GATACAGATCA
TGATACCATGG -> GATACCATGGC
TGATCGGAACG -> GATCGGAACGT
TGATGTCTGTG -> GATGTCTGTGA
TGATTCCCTTA -> GATTCCCTTAT
TGATTGATACC -> GATTGATACCA
TGATTGTGCAG -> GATTGTGCAGT
TGATTTTCTAT -> GATTTTCTATT
TGCAACACCGA -> GCAACACCGAA
TGCAAGAATCG -> GCAAGAATCGT
TGCAAGGAATT -> GCAAGGAATTC
TGCACCGTTAA -> GCACCGTTAAT
TGCACTATCGG -> GCACTATCGGG
TGCAGCTTCTC -> GCAGCTTCTCA
TGCAGTCCAAT -> GCAGTCCAATC
TGCAGTCTTCA -> GCAGTCTTCAT
TGCAGTGGACA -> GCAGTGGACAC
TGCATTCGTGC -> GCATTCGTGCA
TGCCAGGACCC -> GCCAGGACCCT
TGCCAGGGAGG -> GCCAGGGAGGG
TGCCCACCGAG -> GCCCACCGAGG
TGCCCGAGGCA -> GCCCGAGGCAT
TGCCCTTAGCA -> GCCCTTAGCAT
TGCCGCTGCCT -> GCCGCTGCCTG
TGCCTGGGTGT -> GCCTGGGTGTA
TGCGAATTCGA -> GCGAATTCGAG
TGCGATCGCCT -> GCGATCGCCTT
TGCGCCCTTAG -> GCGCCCTTAGT
TGCGCGGCGCT -> GCGCGGCGCTC
TGCGCGTCGGC -> GCGCGTCGGCC
TGCGCTAGTTT -> GCGCTAGTTTT
TGCGTCCGTCC -> GCGTCCGTCCA
TGCGTCTTCTC -> GCGTCTTCTCC
TGCGTGGCATA -> GCGTGGCATAC
TGCGTTACATG -> GCGTTACATGT
TGCTAACGGAC -> GCTAACGGACT
TGCTACGATCC -> GCTACGATCCC
TGCTACTTCAA -> GCTACTTCAAA
TGCTAGGACCT -> GCTAGGACCTC
TGCTCAATAAA -> GCTCAATAAAT
TGCTGAGTCTT -> GCTGAGTCTTC
TGCTGCGTGGC -> GCTGCGTGGCA
TGCTGCTGAGT -> GCTGCTGAGTC
TGCTGTTGCGT -> GCTGTTGCGTC
TGCTTACCGAT -> GCTTACCGATG
TGCTTGGGTAA -> GCTTGGGTAAG
TGGAAAAGTCA -> GGAAAAGTCAG
TGGAAACATAC -> GGAAACATACG
TGGAACTTAAT -> GGAACTTAATA
TGGAAGCTTTG -> GGAAGCTTTGG
TGGAATAGTCA -> GGAATAGTCAC
TGGACACGTTG -> GGACACGTTGT
TGGACAGTCTT -> GGACAGTCTTG
TGGACCGTCTA -> GGACCGTCTAG
TGGACGCCTGG -> GGACGCCTGGA
TGGACTAACTG -> GGACTAACTGG
TGGAGCCCTTT -> GGAGCCCTTTG
TGGAGGTGGCC -> GGAGGTGGCCG
TGGATTAGACA -> GGATTAGACAC
TGGCAACCGGG -> GGCAACCGGGG
TGGCAATAACT -> GGCAATAACTG
TGGCATACATT -> GGCATACATTG
TGGCCACACTG -> GGCCACACTGC
TGGCCCATTAG -> GGCCCATTAGT
TGGCCCCCGGT -> GGCCCCCGGTC
TGGCCGTCAGT -> GGCCGTCAGTC
TGGCTACCTCC -> GGCTACCTCCG
TGGGACCCTGC -> GGGACCCTGCT
TGGGAGGATTG -> GGGAGGATTGC
TGGGATTGAAA -> GGGATTGAAAG
TGGGCGACGAG -> GGGCGACGAGC
TGGGCTATTTT -> GGGCTATTTTA
TGGGCTGGGAT -> GGGCTGGGATT
TGGGCTTCTTT -> GGGCTTCTTTG
TGGGGACAATA -> GGGGACAATAC
TGGGTAAGGTC -> GGGTAAGGTCA
TGGGTGTACAG -> GGGTGTACAGC
TGGTACTCCTG -> GGTACTCCTGC
TGGTATACGTA -> GGTATACGTAG
TGGTATGTCTG -> GGTATGTCTGT
TGGTGTTAGGC -> GGTGTTAGGCT
TGTAATTTGTG -> GTAATTTGTGT
TGTACAGCGAA -> GTACAGCGAAC
TGTAGCCTCGA -> GTAGCCTCGAA
TGTAGGGATCA -> GTAGGGATCAT
TGTCACGAGAA -> GTCACGAGAAT
TGTCCCTGTAG -> GTCCCTGTAGC
TGTCCGCCCGT -> GTCCGCCCGTG
TGTCCTCATGC -> GTCCTCATGCA
TGTCCTTAATG -> GTCCTTAATGG
TGTCGACATTG -> GTCGACATTGC
TGTCGATATCT -> GTCGATATCTG
TGTCTGGACAG -> GTCTGGACAGT
TGTCTGTGAAT -> GTCTGTGAATG
TGTCTGTTCCC -> GTCTGTTCCCG
TGTCTGTTCCG -> GTCTGTTCCGG
TGTCTTAGTTG -> GTCTTAGTTGT
TGTGAACAACA -> GTGAACAACAG
TGTGAATCAAA -> GTGAATCAAAT
TGTGAATGATA -> GTGAATGATAC
TGTGATGTCTG -> GTGATGTCTGT
TGTGCAGTCCA -> GTGCAGTCCAA
TGTGCCCGAGG -> GTGCCCGAGGC
TGTGCTGCGTG -> GTGCTGCGTGG
TGTGGCTACCT -> GTGGCTACCTC
TGTGGGCTATT -> GTGGGCTATTT
TGTGGGCTGGG -> GTGGGCTGGGA
TGTGTGAATCA -> GTGTGAATCAA
TGTGTGATGTC -> GTGTGATGTCT
TGTTACAATCG -> GTTACAATCGG
TGTTAGGCTGC -> GTTAGGCTGCT
TGTTAGGCTTG -> GTTAGGCTTGG
TGTTATGCTGT -> GTTATGCTGTT
TGTTCATACGT -> GTTCATACGTC
TGTTCCATAAG -> GTTCCATAAGT
TGTTCCCGCCA -> GTTCCCGCCAT
TGTTCCGGTCA -> GTTCCGGTCAA
TGTTCGCAGCG -> GTTCGCAGCGT
TGTTCGCGGAG -> GTTCGCGGAGG
TGTTGCGTCTT -> GTTGCGTCTTC
TGTTGGACGCC -> GTTGGACGCCT
TGTTGGGGACA -> GTTGGGGACAA
TGTTGTCCTCA -> GTTGTCCTCAT
TTAACCTTACT -> TAACCTTACTA
TTAACTCGACA -> TAACTCGACAT
TTAAGCTGAGC -> TAAGCTGAGCT
TTAATAAGTGC -> TAATAAGTGCG
TTAATGGAATA -> TAATGGAATAG
TTAATTGGAAA -> TAATTGGAAAA
TTACAATCGGA -> TACAATCGGAT
TTACATGTCGA -> TACATGTCGAC
TTACCATGTTC -> TACCATGTTCA
TTACCCGTTGC -> TACCCGTTGCC
TTACCGATGCT -> TACCGATGCTG
TTACGCCTACA -> TACGCCTACAG
TTACTACTAAG -> TACTACTAAGC
TTACTAGTGCT -> TACTAGTGCTT
TTAGACACGGG -> TAGACACGGGT
TTAGATTTATG -> TAGATTTATGC
TTAGCAAACAT -> TAGCAAACATG
TTAGCAGGTCG -> TAGCAGGTCGA
TTAGCATGAGG -> TAGCATGAGGC
TTAGCCTGCAT -> TAGCCTGCATT
TTAGGCTGCTT -> TAGGCTGCTTA
TTAGGCTTGGC -> TAGGCTTGGCC
TTAGTCCTCCG -> TAGTCCTCCGA
TTAGTGCTACG -> TAGTGCTACGA
TTAGTTGTGCC -> TAGTTGTGCCC
TTATAACTGCA -> TATAACTGCAG
TTATATAAAGT -> TATATAAAGTG
TTATATAATGT -> TATATAATGTT
TTATATCAATT -> TATATCAATTC
TTATGCGATCG -> TATGCGATCGC
TTATGCTCAAT -> TATGCTCAATA
TTATGCTGTTG -> TATGCTGTTGC
TTATGTTCGCG -> TATGTTCGCGG
TTATTGTTGGG -> TATTGTTGGGG
TTCAAAGTCGT -> TCAAAGTCGTC
TTCACTGTAAT -> TCACTGTAATT
TTCACTGTGCT -> TCACTGTGCTG
TTCAGAACAAG -> TCAGAACAAGC
TTCAGATTGAC -> TCAGATTGACT
TTCAGTCCCTA -> TCAGTCCCTAA
TTCAGTTCTTA -> TCAGTTCTTAT
TTCATACGTCT -> TCATACGTCTG
TTCATGAAAGG -> TCATGAAAGGC
TTCATGTCCGC -> TCATGTCCGCC
TTCATGTGGGC -> TCATGTGGGCT
TTCATTGTCCT -> TCATTGTCCTT
TTCCACTTCAG -> TCCACTTCAGT
TTCCATAAGTT -> TCCATAAGTTG
TTCCATGATTG -> TCCATGATTGT
TTCCCCGGCCT -> TCCCCGGCCTA
TTCCCGCCATG -> TCCCGCCATGC
TTCCCTAAGGG -> TCCCTAAGGGA
TTCCCTTATAT -> TCCCTTATATA
TTCCGCATCGC -> TCCGCATCGCC
TTCCGGTCAAT -> TCCGGTCAATA
TTCCTGGGCTT -> TCCTGGGCTTC
TTCCTTGCGAA -> TCCTTGCGAAT
TTCGAACAAGC -> TCGAACAAGCG
TTCGACCTCAA -> TCGACCTCAAT
TTCGAGTAGAA -> TCGAGTAGAAA
TTCGCAGCGTG -> TCGCAGCGTGA
TTCGCCTAAGA -> TCGCCTAAGAA
TTCGCGGAGGA -> TCGCGGAGGAC
TTCGGACAGTC -> TCGGACAGTCA
TTCGGATGTTG -> TCGGATGTTGT
TTCGGGAAAAT -> TCGGGAAAATT
TTCGTGCAGCT -> TCGTGCAGCTT
TTCGTTCCCCG -> TCGTTCCCCGG
TTCTACAACAA -> TCTACAACAAG
TTCTATTATGC -> TCTATTATGCT
TTCTCAAACCT -> TCTCAAACCTT
TTCTCATAGTT -> TCTCATAGTTT
TTCTCCGATCC -> TCTCCGATCCC
TTCTTATATAA -> TCTTATATAAT
TTCTTTCCACT -> TCTTTCCACTT
TTCTTTGCCAG -> TCTTTGCCAGG
TTGAAAGCTTG -> TGAAAGCTTGT
TTGACATACTA -> TGACATACTAT
TTGACTGACGT -> TGACTGACGTG
TTGACTGAGAA -> TGACTGAGAAC
TTGAGAAGTTC -> TGAGAAGTTCC
TTGATACCATG -> TGATACCATGG
TTGATTTTCTA -> TGATTTTCTAT
TTGCCAGGACC -> TGCCAGGACCC
TTGCCCACCGA -> TGCCCACCGAG
TTGCCCTTAGC -> TGCCCTTAGCA
TTGCGAATTCG -> TGCGAATTCGA
TTGCGCCCTTA -> TGCGCCCTTAG
TTGCGCGGCGC -> TGCGCGGCGCT
TTGCGTCCGTC -> TGCGTCCGTCC
TTGCGTCTTCT -> TGCGTCTTCTC
TTGGAAAAGTC -> TGGAAAAGTCA
TTGGAAGCTTT -> TGGAAGCTTTG
TTGGACGCCTG -> TGGACGCCTGG
TTGGAGGTGGC -> TGGAGGTGGCC
TTGGCAACCGG -> TGGCAACCGGG
TTGGCCACACT -> TGGCCACACTG
TTGGGAGGATT -> TGGGAGGATTG
TTGGGGACAAT -> TGGGGACAATA
TTGGGTAAGGT -> TGGGTAAGGTC
TTGGTATACGT -> TGGTATACGTA
TTGGTATGTCT -> TGGTATGTCTG
TTGTCACGAGA -> TGTCACGAGAA
TTGTCCTCATG -> TGTCCTCATGC
TTGTCCTTAAT -> TGTCCTTAATG
TTGTCGATATC -> TGTCGATATCT
TTGTCTTAGTT -> TGTCTTAGTTG
TTGTGAACAAC -> TGTGAACAACA
TTGTGCAGTCC -> TGTGCAGTCCA
TTGTGCCCGAG -> TGTGCCCGAGG
TTGTGGGCTGG -> TGTGGGCTGGG
TTGTGTGATGT -> TGTGTGATGTC
TTGTTGGGGAC -> TGTTGGGGACA
TTTAACCTTAC -> TTAACCTTACT
TTTACCATGTT -> TTACCATGTTC
TTTAGATTTAT -> TTAGATTTATG
TTTAGCCTGCA -> TTAGCCTGCAT
TTTATATCAAT -> TTATATCAATT
TTTATGCGATC -> TTATGCGATCG
TTTATGTTCGC -> TTATGTTCGCG
TTTCACTGTGC -> TTCACTGTGCT
TTTCATTGTCC -> TTCATTGTCCT
TTTCCACTTCA -> TTCCACTTCAG
TTTCCTGGGCT -> TTCCTGGGCTT
TTTCGCCTAAG -> TTCGCCTAAGA
TTTCGGGAAAA -> TTCGGGAAAAT
TTTCGTTCCCC -> TTCGTTCCCCG
TTTCTACAACA -> TTCTACAACAA
TTTCTATTATG -> TTCTATTATGC
TTTGCCAGGAC -> TTGCCAGGACC
TTTGCGCGGCG -> TTGCGCGGCGC
TTTGGAAGCTT -> TTGGAAGCTTT
TTTGGAGGTGG -> TTGGAGGTGGC
TTTGGGAGGAT -> TTGGGAGGATT
TTTGGTATACG -> TTGGTATACGT
TTTGTCACGAG -> TTGTCACGAGA
TTTGTCGATAT -> TTGTCGATATC
TTTGTGTGATG -> TTGTGTGATGT
TTTTAACCTTA -> TTTAACCTTAC
TTTTACCATGT -> TTTACCATGTT
TTTTAGCCTGC -> TTTAGCCTGCA
TTTTATGTTCG -> TTTATGTTCGC
TTTTCACTGTG -> TTTCACTGTGC
TTTTCGGGAAA -> TTTCGGGAAAA
TTTTCGTTCCC -> TTTCGTTCCCC
TTTTCTATTAT -> TTTCTATTATG
TTTTGGTATAC -> TTTGGTATACG
TTTTTAACCTT -> TTTTAACCTTA
TTTTTCGGGAA -> TTTTCGGGAAA
TTTTTTAACCT -> TTTTTAACCTT
